//MAP CONVERTED BY dmm2tgm.py THIS HEADER COMMENT PREVENTS RECONVERSION, DO NOT REMOVE
"ar" = (
/obj/structure/stone_tile/cracked{
	dir = 4
	},
/obj/structure/stone_tile/surrounding_tile{
	dir = 1
	},
/obj/structure/stone_tile/block/cracked,
/turf/open/indestructible/boss,
/area/ruin)
"aX" = (
/obj/item/borg/upgrade/modkit/cooldown,
/obj/item/stack/sheet/mineral/gold/five,
/obj/item/stack/sheet/mineral/diamond,
/turf/open/floor/mineral/gold,
/area/ruin/powered)
"cd" = (
/obj/item/coin/gold,
/obj/item/stack/sheet/mineral/diamond,
/turf/open/floor/mineral/gold,
/area/ruin/powered)
"cf" = (
/obj/structure/stone_tile/slab/cracked,
/turf/open/indestructible/boss,
/area/ruin)
"ci" = (
/obj/structure/stone_tile/slab/cracked,
/turf/open/floor/grass/snow/basalt,
/area/icemoon/surface/outdoors)
"ct" = (
/obj/structure/stone_tile/cracked,
/turf/open/floor/grass/snow/basalt,
/area/icemoon/surface/outdoors)
"cA" = (
/obj/structure/stone_tile/surrounding_tile/cracked{
	dir = 1
	},
/obj/structure/stone_tile/surrounding_tile/cracked,
/obj/structure/stone_tile/surrounding_tile/cracked{
	dir = 4
	},
/turf/template_noop,
/area/template_noop)
"dK" = (
/obj/item/stack/spacecash/c1000,
/turf/open/floor/mineral/gold,
/area/ruin/powered)
"dS" = (
/obj/structure/stone_tile/block/cracked{
	dir = 4
	},
/obj/structure/stone_tile/cracked{
	dir = 4
	},
/turf/open/floor/grass/snow/basalt,
/area/icemoon/surface/outdoors)
"dV" = (
/obj/structure/stone_tile/slab,
/turf/open/indestructible/boss,
/area/ruin)
"eg" = (
/obj/structure/stone_tile/surrounding_tile/cracked{
	dir = 1
	},
/obj/structure/stone_tile/block/cracked{
	dir = 10
	},
/turf/open/floor/grass/snow/basalt,
/area/icemoon/surface/outdoors)
"ex" = (
/obj/structure/stone_tile/surrounding_tile/cracked{
	dir = 1
	},
/obj/structure/stone_tile/surrounding_tile/cracked{
	dir = 8
	},
/turf/open/floor/grass/snow/basalt,
/area/icemoon/surface/outdoors)
"eS" = (
/obj/structure/grille/indestructable,
/turf/open/floor/plasteel/rockvault/sandstone,
/area/ruin/powered)
"eU" = (
/obj/item/coin/gold,
/obj/item/stack/spacecash/c1000,
/turf/open/floor/mineral/gold,
/area/ruin/powered)
"fG" = (
/obj/structure/stone_tile/surrounding_tile/cracked{
	dir = 4
	},
/obj/structure/stone_tile/surrounding_tile/cracked{
	dir = 1
	},
/obj/structure/stone_tile/center,
/turf/open/floor/grass/snow/basalt,
/area/icemoon/surface/outdoors)
"fY" = (
/turf/open/floor/grass/snow/basalt,
/area/icemoon/surface/outdoors)
"gC" = (
/obj/item/storage/bag/quiver/empty,
/turf/open/floor/mineral/gold,
/area/ruin/powered)
"hh" = (
/obj/structure/stone_tile/slab,
/turf/closed/indestructible/riveted/uranium{
	base_icon_state = "iron_wall";
	icon = 'icons/turf/walls/iron_wall.dmi';
	icon_state = "iron_wall-0"
	},
/area/ruin)
"ie" = (
/turf/closed/indestructible/riveted{
	base_icon_state = "iron_wall";
	icon = 'icons/turf/walls/iron_wall.dmi';
	icon_state = "iron_wall-0"
	},
/area/ruin)
"if" = (
/obj/structure/flora/rock/icy,
/turf/template_noop,
/area/template_noop)
"ih" = (
/obj/item/coin/gold,
/obj/item/stack/spacecash/c1000,
/turf/open/floor/mineral/gold,
/area/icemoon/underground/explored)
"iu" = (
/obj/structure/stone_tile/surrounding_tile/cracked{
	dir = 8
	},
/turf/template_noop,
/area/template_noop)
"iT" = (
/obj/structure/stone_tile/slab,
/mob/living/simple_animal/hostile/megafauna/dragon/icemoon,
/turf/open/indestructible/boss,
/area/ruin)
"jf" = (
/obj/structure/stone_tile/slab/cracked,
/turf/closed/indestructible/riveted/uranium{
	base_icon_state = "iron_wall";
	icon = 'icons/turf/walls/iron_wall.dmi';
	icon_state = "iron_wall-0"
	},
/area/ruin)
"jE" = (
/obj/structure/stone_tile/slab/cracked{
	dir = 6
	},
/turf/open/floor/grass/snow/basalt,
/area/icemoon/surface/outdoors)
"jQ" = (
/obj/structure/stone_tile/surrounding_tile/cracked{
	dir = 8
	},
/obj/structure/stone_tile/surrounding_tile/cracked{
	dir = 4
	},
/obj/structure/stone_tile/surrounding_tile/cracked{
	dir = 1
	},
/turf/open/floor/grass/snow/basalt,
/area/icemoon/surface/outdoors)
"ka" = (
/obj/structure/flora/grass/brown,
/turf/template_noop,
/area/template_noop)
"kd" = (
/obj/item/coin/gold,
/obj/item/ammo_casing/caseless/arrow/ash,
/turf/open/floor/mineral/gold,
/area/ruin/powered)
"kA" = (
/obj/item/nullrod/scythe/talking/necro,
/turf/open/floor/mineral/gold,
/area/ruin/powered)
"kC" = (
/obj/structure/stone_tile/slab,
/obj/structure/necropolis_gate,
/turf/open/indestructible/boss,
/area/ruin)
"kP" = (
/obj/item/clothing/head/helmet/knight,
/turf/open/floor/mineral/gold,
/area/ruin/powered)
"li" = (
/obj/structure/stone_tile/slab,
/turf/open/floor/plating/asteroid/snow/icemoon,
/area/icemoon/surface/outdoors)
"mx" = (
/obj/structure/stone_tile/block/cracked{
	dir = 8
	},
/obj/structure/stone_tile/cracked,
/turf/template_noop,
/area/template_noop)
"nD" = (
/turf/closed/indestructible/riveted{
	base_icon_state = "iron_wall";
	icon = 'icons/turf/walls/iron_wall.dmi';
	icon_state = "iron_wall-0"
	},
/area/ruin/powered)
"qa" = (
/obj/structure/stone_tile/surrounding_tile/cracked{
	dir = 1
	},
/turf/template_noop,
/area/template_noop)
"rX" = (
/turf/closed/indestructible/riveted/uranium{
	base_icon_state = "iron_wall";
	icon = 'icons/turf/walls/iron_wall.dmi';
	icon_state = "iron_wall-0"
	},
/area/ruin)
"rY" = (
/obj/structure/stone_tile/block/cracked{
	dir = 9
	},
/obj/structure/stone_tile/block/cracked{
	dir = 4
	},
/turf/open/floor/grass/snow/basalt,
/area/icemoon/surface/outdoors)
"sm" = (
/obj/structure/stone_tile/slab/cracked,
/obj/machinery/door/poddoor/gates/indestructible{
	id = "ash_drake_dead"
	},
/obj/structure/fans/tiny/invisible,
/turf/open/indestructible/boss{
	initial_gas_mix = "o2=22;n2=82;TEMP=293.15"
	},
/area/ruin/powered)
"tm" = (
/obj/structure/stone_tile/surrounding_tile/cracked{
	dir = 4
	},
/obj/structure/stone_tile/center,
/obj/structure/stone_tile/surrounding_tile/cracked{
	dir = 1
	},
/obj/structure/stone_tile/surrounding_tile/cracked{
	dir = 8
	},
/turf/open/floor/grass/snow/basalt,
/area/icemoon/surface/outdoors)
"tD" = (
/turf/template_noop,
/area/template_noop)
"tI" = (
/obj/structure/flora/tree/dead,
/turf/template_noop,
/area/template_noop)
"uu" = (
/turf/open/floor/plasteel/rockvault/sandstone,
/area/ruin/powered)
"va" = (
/obj/structure/stone_tile/cracked{
	dir = 8
	},
/obj/structure/stone_tile/cracked,
/obj/structure/stone_tile/block/cracked{
	dir = 1
	},
/turf/open/indestructible/boss,
/area/ruin)
"vB" = (
/obj/item/clothing/head/helmet/knight,
/obj/item/ammo_casing/caseless/arrow/ash,
/turf/open/floor/mineral/gold,
/area/ruin/powered)
"wf" = (
/obj/structure/stone_tile/slab/cracked{
	dir = 4
	},
/turf/open/floor/grass/snow/basalt,
/area/icemoon/surface/outdoors)
"wl" = (
/obj/item/clothing/suit/armor/vest/capcarapace,
/turf/open/floor/mineral/gold,
/area/ruin/powered)
"wD" = (
/obj/item/clothing/head/caphat/nt,
/turf/open/floor/mineral/gold,
/area/ruin/powered)
"wK" = (
/obj/structure/stone_tile/center,
/obj/structure/stone_tile/surrounding_tile{
	dir = 8
	},
/obj/structure/stone_tile/surrounding_tile/cracked{
	dir = 4
	},
/obj/structure/stone_tile/surrounding_tile/cracked,
/turf/open/indestructible/boss{
	initial_gas_mix = "o2=22;n2=82;TEMP=293.15"
	},
/area/ruin/powered)
"xo" = (
/obj/structure/stone_tile/slab,
/obj/machinery/door/poddoor/gates/indestructible{
	id = "ash_drake_dead"
	},
/obj/structure/fans/tiny/invisible,
/turf/open/indestructible/boss{
	initial_gas_mix = "o2=22;n2=82;TEMP=293.15"
	},
/area/ruin/powered)
"xu" = (
/obj/structure/stone_tile/slab,
/turf/open/indestructible/boss{
	initial_gas_mix = "o2=22;n2=82;TEMP=293.15"
	},
/area/ruin/powered)
"xW" = (
/obj/item/clothing/suit/armor/riot/knight,
/turf/open/floor/mineral/gold,
/area/ruin/powered)
"xX" = (
/obj/structure/bonfire/prelit,
/turf/open/floor/plasteel/rockvault/sandstone,
/area/ruin/powered)
"yx" = (
/obj/structure/stone_tile/slab/cracked,
/obj/machinery/door/poddoor/gates/indestructible{
	id = "ash_drake_dead"
	},
/turf/open/indestructible/boss{
	initial_gas_mix = "o2=22;n2=82;TEMP=293.15"
	},
/area/ruin/powered)
"yA" = (
/obj/structure/stone_tile/slab,
/obj/machinery/door/poddoor/gates/indestructible{
	id = "ash_drake_dead"
	},
/turf/open/indestructible/boss{
	initial_gas_mix = "o2=22;n2=82;TEMP=293.15"
	},
/area/ruin/powered)
"yL" = (
/obj/structure/stone_tile/block/cracked{
	dir = 9
	},
/obj/structure/stone_tile/surrounding_tile/cracked{
	dir = 8
	},
/turf/open/floor/grass/snow/basalt,
/area/icemoon/surface/outdoors)
"Ai" = (
/obj/structure/stone_tile/cracked,
/turf/template_noop,
/area/template_noop)
"Ax" = (
/obj/item/stack/sheet/mineral/gold/five,
/turf/open/floor/mineral/gold,
/area/ruin/powered)
"Cc" = (
/obj/structure/closet/crate/necropolis/tendril,
/turf/open/floor/mineral/gold,
/area/ruin/powered)
"CK" = (
/obj/structure/stone_tile/slab/cracked{
	dir = 5
	},
/obj/structure/stone_tile/surrounding_tile/cracked,
/turf/open/floor/grass/snow/basalt,
/area/icemoon/surface/outdoors)
"CN" = (
/obj/structure/stone_tile/cracked{
	dir = 1
	},
/obj/structure/stone_tile/surrounding_tile/cracked{
	dir = 8
	},
/turf/open/floor/grass/snow/basalt,
/area/icemoon/surface/outdoors)
"CS" = (
/obj/structure/stone_tile/cracked{
	dir = 8
	},
/turf/open/floor/grass/snow/basalt,
/area/icemoon/surface/outdoors)
"Dz" = (
/obj/structure/stone_tile/block/cracked{
	dir = 8
	},
/turf/template_noop,
/area/template_noop)
"DL" = (
/obj/structure/flora/rock/pile/icy,
/turf/template_noop,
/area/template_noop)
"DM" = (
/obj/item/coin/gold,
/obj/item/stack/sheet/mineral/gold/five,
/turf/open/floor/mineral/gold,
/area/ruin/powered)
"EF" = (
/obj/structure/bonfire/prelit,
/turf/open/floor/mineral/gold,
/area/ruin/powered)
"Fw" = (
/turf/open/floor/mineral/gold,
/area/ruin/powered)
"FA" = (
/obj/structure/flora/grass/both,
/turf/template_noop,
/area/template_noop)
"FF" = (
/obj/structure/bed/pod,
/obj/item/flashlight/flare/torch,
/obj/effect/landmark/ashdrake_ghost_spawn,
/turf/open/floor/plasteel/rockvault/sandstone,
/area/ruin/powered)
"Gh" = (
/obj/effect/decal/remains/human{
	desc = "Some human remains, the only thing that could burn remains to a crisp like this is a plasmafire, or a dragon..."
	},
/obj/effect/decal/cleanable/ash/large,
/obj/item/shield/riot/roman{
	pixel_x = -12
	},
/obj/item/nullrod/claymore{
	pixel_x = 20
	},
/turf/open/floor/grass/snow/basalt,
/area/icemoon/surface/outdoors)
"Gv" = (
/obj/machinery/door/poddoor/gates/indestructible{
	color = "#EFC51D";
	id = "ash_drake_dead"
	},
/turf/open/floor/mineral/gold,
/area/ruin/powered)
"Hb" = (
/obj/structure/stone_tile/block/cracked{
	dir = 1
	},
/obj/structure/stone_tile/cracked,
/turf/open/floor/grass/snow/basalt,
/area/icemoon/surface/outdoors)
"HL" = (
/obj/structure/stone_tile/cracked{
	dir = 1
	},
/turf/open/floor/grass/snow/basalt,
/area/icemoon/surface/outdoors)
"IB" = (
/obj/structure/stone_tile/block/cracked{
	dir = 1
	},
/obj/structure/stone_tile/block/cracked,
/turf/open/indestructible/boss,
/area/ruin)
"JL" = (
/obj/structure/flora/grass/green,
/turf/template_noop,
/area/template_noop)
"JS" = (
/obj/item/stack/sheet/mineral/diamond,
/turf/open/floor/mineral/gold,
/area/ruin/powered)
"Kg" = (
/obj/structure/sink/puddle,
/turf/open/floor/plasteel/rockvault/sandstone,
/area/ruin/powered)
"Lh" = (
/obj/structure/stone_tile/cracked{
	dir = 8
	},
/obj/structure/stone_tile/slab/cracked{
	dir = 8
	},
/turf/open/floor/grass/snow/basalt,
/area/icemoon/surface/outdoors)
"Li" = (
/obj/structure/fluff/drake_statue,
/turf/template_noop,
/area/template_noop)
"MA" = (
/obj/structure/stone_tile/cracked,
/obj/structure/stone_tile/cracked{
	dir = 4
	},
/obj/structure/stone_tile/surrounding_tile{
	dir = 8
	},
/obj/structure/stone_tile/surrounding_tile{
	dir = 1
	},
/turf/open/indestructible/boss{
	initial_gas_mix = "o2=22;n2=82;TEMP=293.15"
	},
/area/ruin/powered)
"Ov" = (
/obj/structure/stone_tile/slab/cracked{
	dir = 10
	},
/obj/structure/stone_tile/slab/cracked{
	dir = 8
	},
/obj/structure/stone_tile/center,
/turf/template_noop,
/area/template_noop)
"OF" = (
/obj/structure/flora/ash/whitesands/fireblossom,
/obj/structure/stone_tile/cracked{
	dir = 4
	},
/obj/structure/stone_tile/cracked{
	dir = 8
	},
/turf/open/floor/grass/snow/basalt,
/area/icemoon/surface/outdoors)
"Pt" = (
/obj/machinery/button/door{
	id = "ashdrake_cell1";
	pixel_y = 23
	},
/turf/open/floor/plasteel/rockvault/sandstone,
/area/ruin/powered)
"Qu" = (
/obj/structure/stone_tile/slab/cracked{
	dir = 5
	},
/turf/open/floor/grass/snow/basalt,
/area/icemoon/surface/outdoors)
"QM" = (
/obj/item/coin/gold,
/turf/open/floor/mineral/gold,
/area/ruin/powered)
"Sj" = (
/obj/structure/stone_tile/center,
/turf/open/floor/grass/snow/basalt,
/area/icemoon/surface/outdoors)
"SI" = (
/obj/structure/stone_tile/block/cracked{
	dir = 6
	},
/turf/open/floor/grass/snow/basalt,
/area/icemoon/surface/outdoors)
"Tf" = (
/obj/item/coin/gold,
/obj/item/borg/upgrade/modkit/cooldown,
/turf/open/floor/mineral/gold,
/area/ruin/powered)
"Tv" = (
/obj/item/extinguisher/mini,
/obj/structure/stone_tile/cracked{
	dir = 1
	},
/obj/structure/stone_tile/surrounding_tile/cracked,
/turf/open/floor/grass/snow/basalt,
/area/icemoon/surface/outdoors)
"VO" = (
/obj/structure/stone_tile/slab,
/turf/open/floor/grass/snow/basalt,
/area/icemoon/surface/outdoors)
"Wb" = (
/obj/effect/gibspawner,
/obj/item/clothing/head/crown,
/turf/open/floor/plasteel/rockvault/sandstone,
/area/ruin/powered)
"Wp" = (
/obj/structure/stone_tile/cracked{
	dir = 4
	},
/turf/open/floor/grass/snow/basalt,
/area/icemoon/surface/outdoors)
"WN" = (
/obj/machinery/door/airlock/gold/glass,
/turf/open/floor/plasteel/rockvault/sandstone,
/area/ruin/powered)
"Xi" = (
/obj/structure/stone_tile/block/cracked{
	dir = 8
	},
/obj/structure/stone_tile/block/cracked{
	dir = 4
	},
/turf/open/indestructible/boss,
/area/ruin)
"Xq" = (
/obj/structure/bed/pod,
/obj/item/flashlight/flare/torch,
/obj/effect/mob_spawn/human/corpse/wizard,
/turf/open/floor/plasteel/rockvault/sandstone,
/area/ruin/powered)
"XC" = (
/obj/structure/stone_tile/block/cracked{
	dir = 4
	},
/obj/structure/stone_tile/surrounding_tile/cracked{
	dir = 4
	},
/turf/open/floor/grass/snow/basalt,
/area/icemoon/surface/outdoors)
"XG" = (
/obj/machinery/door/poddoor/gates/indestructible{
	id = "ashdrake_cell2"
	},
/turf/open/floor/plasteel/rockvault/sandstone,
/area/ruin/powered)
"XJ" = (
/obj/structure/toilet,
/turf/open/floor/plasteel/rockvault/sandstone,
/area/ruin/powered)
"YK" = (
/obj/structure/stone_tile/block/cracked{
	dir = 4
	},
/turf/template_noop,
/area/template_noop)
"YQ" = (
/obj/machinery/button/door{
	id = "ashdrake_cell2";
	pixel_y = 23
	},
/turf/open/floor/plasteel/rockvault/sandstone,
/area/ruin/powered)
"Ze" = (
/obj/structure/stone_tile/surrounding_tile/cracked{
	dir = 8
	},
/obj/structure/stone_tile/center,
/obj/structure/stone_tile/surrounding_tile/cracked{
	dir = 4
	},
/obj/structure/stone_tile/surrounding_tile/cracked{
	dir = 1
	},
/turf/open/floor/grass/snow/basalt,
/area/icemoon/surface/outdoors)
"Zl" = (
/obj/structure/stone_tile/block/cracked{
	dir = 1
	},
/turf/open/floor/grass/snow/basalt,
/area/icemoon/surface/outdoors)
"Zp" = (
/obj/item/gun/ballistic/bow,
/turf/open/floor/mineral/gold,
/area/ruin/powered)
"ZT" = (
/obj/machinery/door/poddoor/gates/indestructible{
	id = "ashdrake_cell1"
	},
/turf/open/floor/plasteel/rockvault/sandstone,
/area/ruin/powered)
"ZZ" = (
/obj/structure/stone_tile/slab/cracked{
	dir = 4
	},
/turf/template_noop,
/area/template_noop)

(1,1,1) = {"
tD
tD
tD
tD
tD
tD
tD
tD
tD
tD
tD
tD
tD
tD
tD
tD
nD
tD
tD
tD
tD
tD
tD
tD
tD
tD
tD
tD
tD
tD
"}
(2,1,1) = {"
tD
tD
tD
tD
tD
tD
tD
tD
tD
tD
tD
tD
tD
tD
tD
tD
nD
tD
tD
tD
tD
tD
tD
tD
tD
tD
tD
tD
tD
tD
"}
(3,1,1) = {"
tD
tD
tD
tD
tD
tD
tD
tD
tD
nD
nD
nD
nD
nD
nD
nD
nD
tD
tD
tD
tD
tD
tD
tD
tD
tD
tD
tD
tD
tD
"}
(4,1,1) = {"
tD
tD
tD
tD
tD
nD
nD
nD
nD
nD
FF
uu
uu
uu
uu
uu
nD
tD
FA
tD
DL
tD
tI
tD
tD
tD
tD
tD
tD
tD
"}
(5,1,1) = {"
tD
tD
tD
tD
tD
nD
EF
dK
EF
nD
XJ
uu
uu
Wb
uu
Kg
nD
tD
tD
tD
tD
tD
tD
tD
tD
FA
tD
tD
tD
tD
"}
(6,1,1) = {"
tD
tD
tD
tD
tD
nD
JS
DM
Tf
nD
nD
nD
eS
eS
ZT
eS
nD
tD
tD
ka
tD
tD
tD
tD
tD
tD
tD
tD
tD
tD
"}
(7,1,1) = {"
tD
tD
tD
tD
nD
nD
QM
xW
Fw
QM
Fw
nD
Pt
uu
uu
xX
nD
tD
tD
tD
tD
FA
tD
if
tD
tD
tD
tI
tD
tD
"}
(8,1,1) = {"
tD
tD
tD
tD
nD
Fw
QM
QM
cd
gC
dK
WN
uu
uu
uu
uu
nD
tD
DL
tD
tD
tD
tD
tD
tD
tD
tD
tD
tD
tD
"}
(9,1,1) = {"
tD
tD
tD
tD
nD
QM
Fw
Ax
QM
QM
JS
nD
uu
uu
uu
uu
nD
tD
tD
tD
tD
tD
JL
tD
tD
tD
tD
tD
tD
tD
"}
(10,1,1) = {"
tD
tD
tD
tD
nD
QM
xW
eU
Zp
Fw
QM
nD
uu
uu
uu
uu
nD
tD
tD
tD
DL
tD
tD
tD
tD
tD
DL
tD
if
tD
"}
(11,1,1) = {"
tD
tD
tD
tD
nD
dK
QM
QM
dK
Fw
Fw
nD
uu
uu
uu
uu
nD
tD
tI
if
tD
tD
tI
tD
ka
tD
tD
tD
tD
tD
"}
(12,1,1) = {"
tD
tD
tD
tD
nD
Fw
Fw
ih
Ax
QM
EF
nD
xX
uu
uu
xX
nD
tD
tD
tD
tD
tD
tD
tD
tD
ka
tD
tD
tD
tD
"}
(13,1,1) = {"
tD
tD
nD
nD
nD
kP
Fw
QM
EF
nD
ie
ie
ie
ie
ie
rX
ie
Li
tD
tD
tD
tD
tD
tD
tD
tD
tD
tD
tD
tD
"}
(14,1,1) = {"
tD
tD
nD
Cc
Gv
Fw
kP
QM
QM
sm
xu
yx
dV
cf
ar
dV
jf
Hb
CS
ct
wf
rY
CK
HL
CN
mx
Dz
eg
VO
iu
"}
(15,1,1) = {"
tD
tD
nD
kA
Gv
Fw
JS
wl
wD
sm
MA
yA
iT
dV
dV
va
kC
dS
OF
Gh
Tv
ex
Qu
Lh
HL
fY
Ze
jQ
fY
ci
"}
(16,1,1) = {"
tD
tD
nD
Cc
Gv
Fw
Fw
Fw
kP
xo
wK
yA
cf
IB
dV
Xi
hh
Zl
Ov
yL
jE
fG
fY
Wp
XC
ci
Sj
VO
ZZ
li
"}
(17,1,1) = {"
tD
tD
nD
nD
nD
QM
xW
Zp
EF
nD
nD
nD
ie
ie
ie
ie
ie
Li
tD
tD
qa
YK
cA
SI
tm
li
Ai
Ai
tD
tD
"}
(18,1,1) = {"
tD
tD
tD
tD
nD
Fw
Fw
Fw
JS
Fw
EF
nD
xX
uu
uu
xX
nD
tD
tD
tD
tD
tD
tD
tD
tD
tD
tD
tD
tD
tD
"}
(19,1,1) = {"
tD
tD
tD
tD
nD
dK
QM
kd
QM
QM
cd
nD
uu
uu
uu
uu
nD
tD
tD
FA
tD
tD
tD
tD
tD
tD
tD
DL
tD
tD
"}
(20,1,1) = {"
tD
tD
tD
tD
nD
Fw
QM
Fw
Fw
eU
QM
nD
uu
uu
uu
uu
nD
tD
tD
tD
tD
tD
tD
tI
tD
tD
tD
tD
tD
tD
"}
(21,1,1) = {"
tD
tD
tD
tD
nD
QM
Fw
QM
QM
Fw
Fw
WN
uu
uu
uu
uu
nD
if
tD
tD
tI
DL
tD
tD
tD
tD
FA
tD
tD
tD
"}
(22,1,1) = {"
tD
tD
tD
tD
nD
nD
QM
Ax
vB
Fw
QM
nD
YQ
uu
uu
xX
nD
tD
tD
tD
tD
tD
tD
tD
tD
tD
tD
tD
tD
tD
"}
(23,1,1) = {"
tD
tD
tD
tD
tD
nD
JS
QM
aX
nD
nD
nD
eS
eS
XG
eS
nD
tD
tD
tD
if
tD
tD
tD
if
tD
tD
tD
tD
tD
"}
(24,1,1) = {"
tD
tD
tD
tD
tD
nD
EF
Fw
EF
nD
XJ
uu
uu
uu
uu
Kg
nD
tD
ka
tD
tD
tD
tD
FA
tD
tD
tD
tD
tD
tD
"}
(25,1,1) = {"
tD
tD
tD
tD
tD
nD
nD
nD
nD
nD
Xq
uu
uu
uu
uu
uu
nD
tD
tD
tD
ka
tD
tD
tD
tD
tD
FA
tD
tD
tD
"}
(26,1,1) = {"
tD
tD
tD
tD
tD
tD
tD
tD
tD
nD
nD
nD
nD
nD
nD
nD
nD
tD
tD
tD
tD
tD
tD
tD
tD
tD
tD
tD
tD
tD
"}
(27,1,1) = {"
tD
tD
tD
tD
tD
tD
tD
tD
tD
tD
tD
tD
tD
tD
tD
tD
nD
tD
tD
tI
tD
tD
tD
tD
tD
tD
tD
tD
tD
tD
"}
(28,1,1) = {"
tD
tD
tD
tD
tD
tD
tD
tD
tD
tD
tD
tD
tD
tD
tD
tD
nD
tD
tD
tD
tD
tD
tD
tD
tD
tD
tD
tD
tD
tD
"}
