//MAP CONVERTED BY dmm2tgm.py THIS HEADER COMMENT PREVENTS RECONVERSION, DO NOT REMOVE
"c" = (
/turf/template_noop,
/area/template_noop)
"d" = (
/obj/mecha/working/ripley/mining{
	ruin_mecha = 1
	},
/obj/effect/mapping_helpers/no_lava,
/turf/template_noop,
/area/template_noop)
"e" = (
/obj/item/clothing/shoes/workboots/mining,
/obj/item/clothing/under/rank/cargo/miner/lavaland,
/obj/effect/decal/remains/human,
/obj/effect/mapping_helpers/no_lava,
/turf/template_noop,
/area/template_noop)

(1,1,1) = {"
c
c
c
c
c
"}
(2,1,1) = {"
c
c
c
c
c
"}
(3,1,1) = {"
c
c
d
e
c
"}
(4,1,1) = {"
c
c
c
c
c
"}
(5,1,1) = {"
c
c
c
c
c
"}
