//MAP CONVERTED BY dmm2tgm.py THIS HEADER COMMENT PREVENTS RECONVERSION, DO NOT REMOVE
"d" = (
/turf/template_noop,
/area/template_noop)
"e" = (
/obj/effect/decal/remains/human,
/turf/template_noop,
/area/template_noop)
"r" = (
/obj/machinery/wish_granter,
/obj/effect/mapping_helpers/no_lava,
/turf/open/floor/plating/asteroid/basalt/lava_land_surface,
/area/overmap_encounter/planetoid/lava)
"A" = (
/turf/closed/indestructible/riveted,
/area/overmap_encounter/planetoid/lava)

(1,1,1) = {"
d
d
d
d
d
d
d
d
d
d
d
d
d
d
d
"}
(2,1,1) = {"
d
d
e
d
d
d
d
e
d
d
d
d
d
d
d
"}
(3,1,1) = {"
d
d
d
d
d
d
d
d
d
d
d
d
d
e
d
"}
(4,1,1) = {"
e
d
d
d
e
d
d
d
d
d
e
d
d
d
d
"}
(5,1,1) = {"
d
d
d
d
d
d
e
e
d
e
e
d
d
d
d
"}
(6,1,1) = {"
d
d
d
d
e
A
A
A
A
A
d
d
d
d
d
"}
(7,1,1) = {"
d
d
e
d
d
A
A
A
A
A
d
e
d
d
d
"}
(8,1,1) = {"
d
d
d
e
d
A
A
r
A
A
d
d
d
d
d
"}
(9,1,1) = {"
d
d
d
d
e
A
A
A
A
A
e
e
d
d
d
"}
(10,1,1) = {"
d
d
e
d
d
A
A
A
A
A
d
e
d
d
d
"}
(11,1,1) = {"
d
d
d
d
d
e
d
e
e
d
e
d
d
d
d
"}
(12,1,1) = {"
d
d
d
d
d
d
e
d
d
d
d
d
d
d
d
"}
(13,1,1) = {"
d
d
d
d
d
d
d
d
d
d
d
d
d
e
d
"}
(14,1,1) = {"
d
e
d
d
d
d
d
e
d
d
d
d
d
d
d
"}
(15,1,1) = {"
d
d
d
d
d
e
d
d
d
d
d
d
d
d
d
"}
