//MAP CONVERTED BY dmm2tgm.py THIS HEADER COMMENT PREVENTS RECONVERSION, DO NOT REMOVE
"b" = (
/turf/open/floor/plating/asteroid/basalt/lava_land_surface,
/area/ruin/unpowered)
"c" = (
/turf/template_noop,
/area/template_noop)
"d" = (
/obj/structure/stone_tile/slab,
/turf/template_noop,
/area/ruin/unpowered)
"e" = (
/obj/structure/stone_tile,
/obj/structure/stone_tile{
	dir = 8
	},
/obj/structure/stone_tile/cracked{
	dir = 4
	},
/obj/structure/stone_tile/cracked{
	dir = 1
	},
/turf/open/indestructible/boss,
/area/ruin/unpowered)
"f" = (
/obj/structure/stone_tile/block,
/obj/structure/stone_tile{
	dir = 1
	},
/obj/structure/stone_tile{
	dir = 4
	},
/turf/open/indestructible/boss,
/area/ruin/unpowered)
"g" = (
/obj/structure/stone_tile/block,
/obj/structure/stone_tile{
	dir = 1
	},
/obj/structure/stone_tile{
	dir = 4
	},
/obj/effect/decal/cleanable/blood,
/turf/open/indestructible/boss,
/area/ruin/unpowered)
"h" = (
/obj/structure/stone_tile/block,
/obj/structure/stone_tile/cracked{
	dir = 1
	},
/obj/structure/stone_tile{
	dir = 4
	},
/turf/open/indestructible/boss,
/area/ruin/unpowered)
"i" = (
/obj/structure/stone_tile,
/obj/structure/stone_tile{
	dir = 1
	},
/obj/structure/stone_tile/cracked{
	dir = 4
	},
/obj/structure/stone_tile/cracked{
	dir = 8
	},
/turf/open/indestructible/boss,
/area/ruin/unpowered)
"j" = (
/obj/structure/stone_tile/block/cracked{
	dir = 4
	},
/obj/structure/stone_tile/cracked{
	dir = 4
	},
/obj/structure/stone_tile{
	dir = 8
	},
/turf/open/indestructible/boss,
/area/ruin/unpowered)
"k" = (
/obj/structure/stone_tile/surrounding_tile/cracked,
/obj/structure/stone_tile/center,
/obj/structure/stone_tile/surrounding_tile{
	dir = 1
	},
/obj/structure/stone_tile/surrounding_tile{
	dir = 8
	},
/turf/open/indestructible/necropolis,
/area/ruin/unpowered)
"l" = (
/obj/structure/stone_tile/block/cracked,
/turf/open/indestructible/necropolis,
/area/ruin/unpowered)
"m" = (
/obj/structure/stone_tile/surrounding_tile/cracked,
/obj/structure/stone_tile/surrounding_tile/cracked{
	dir = 4
	},
/obj/structure/stone_tile/center,
/obj/structure/stone_tile/surrounding_tile{
	dir = 8
	},
/turf/open/indestructible/necropolis,
/area/ruin/unpowered)
"n" = (
/obj/structure/stone_tile/block/cracked{
	dir = 8
	},
/obj/structure/stone_tile/cracked{
	dir = 1
	},
/obj/structure/stone_tile,
/turf/open/indestructible/boss,
/area/ruin/unpowered)
"o" = (
/obj/structure/stone_tile/block{
	dir = 4
	},
/obj/structure/stone_tile{
	dir = 8
	},
/obj/structure/stone_tile{
	dir = 4
	},
/obj/effect/decal/cleanable/blood,
/turf/open/indestructible/boss,
/area/ruin/unpowered)
"p" = (
/obj/structure/stone_tile/block/cracked{
	dir = 4
	},
/obj/structure/table/bronze,
/obj/item/disk/design_disk/adv/knight_gear,
/turf/open/indestructible/necropolis,
/area/ruin/unpowered)
"q" = (
/obj/structure/table/bronze,
/obj/item/stack/sheet/mineral/runite{
	amount = 5
	},
/turf/open/indestructible/necropolis,
/area/ruin/unpowered)
"r" = (
/obj/structure/stone_tile/block{
	dir = 8
	},
/obj/structure/table/bronze,
/obj/item/stack/sheet/mineral/runite{
	amount = 5
	},
/turf/open/indestructible/necropolis,
/area/ruin/unpowered)
"s" = (
/obj/structure/stone_tile/block{
	dir = 8
	},
/obj/structure/stone_tile,
/obj/structure/stone_tile{
	dir = 1
	},
/turf/open/indestructible/boss,
/area/ruin/unpowered)
"t" = (
/obj/structure/stone_tile/block{
	dir = 4
	},
/obj/structure/stone_tile{
	dir = 8
	},
/obj/structure/stone_tile{
	dir = 4
	},
/turf/open/indestructible/boss,
/area/ruin/unpowered)
"u" = (
/obj/structure/stone_tile/surrounding_tile/cracked{
	dir = 4
	},
/obj/structure/stone_tile/center/cracked,
/obj/structure/stone_tile/surrounding_tile,
/obj/structure/stone_tile/surrounding_tile{
	dir = 1
	},
/turf/open/indestructible/necropolis,
/area/ruin/unpowered)
"v" = (
/obj/structure/stone_tile/block{
	dir = 1
	},
/turf/open/indestructible/necropolis,
/area/ruin/unpowered)
"w" = (
/obj/structure/stone_tile/surrounding_tile/cracked{
	dir = 8
	},
/obj/structure/stone_tile/center,
/obj/structure/stone_tile/surrounding_tile{
	dir = 1
	},
/obj/structure/stone_tile/surrounding_tile{
	dir = 4
	},
/turf/open/indestructible/necropolis,
/area/ruin/unpowered)
"x" = (
/obj/structure/stone_tile/block{
	dir = 8
	},
/obj/structure/stone_tile/cracked{
	dir = 1
	},
/obj/structure/stone_tile,
/turf/open/indestructible/boss,
/area/ruin/unpowered)
"y" = (
/obj/structure/stone_tile,
/obj/structure/stone_tile{
	dir = 8
	},
/obj/structure/stone_tile{
	dir = 1
	},
/obj/structure/stone_tile{
	dir = 4
	},
/turf/open/indestructible/boss,
/area/ruin/unpowered)
"z" = (
/obj/structure/stone_tile/block{
	dir = 1
	},
/obj/structure/stone_tile/cracked,
/obj/structure/stone_tile{
	dir = 8
	},
/turf/open/indestructible/boss,
/area/ruin/unpowered)
"A" = (
/obj/structure/stone_tile/slab/cracked,
/turf/open/indestructible/boss,
/area/ruin/unpowered)
"B" = (
/obj/structure/stone_tile/block/cracked{
	dir = 1
	},
/obj/structure/stone_tile{
	dir = 8
	},
/obj/structure/stone_tile,
/obj/effect/decal/cleanable/blood,
/turf/open/indestructible/boss,
/area/ruin/unpowered)
"C" = (
/obj/structure/stone_tile,
/obj/structure/stone_tile{
	dir = 8
	},
/obj/structure/stone_tile{
	dir = 1
	},
/obj/structure/stone_tile/cracked{
	dir = 4
	},
/turf/open/indestructible/boss,
/area/ruin/unpowered)
"D" = (
/turf/closed/indestructible/riveted/boss,
/area/ruin/unpowered)
"E" = (
/obj/structure/stone_tile/block{
	dir = 4
	},
/obj/structure/stone_tile/block/cracked{
	dir = 8
	},
/turf/open/indestructible/boss,
/area/ruin/unpowered)
"F" = (
/obj/structure/stone_tile/slab,
/obj/effect/mapping_helpers/no_lava,
/turf/open/floor/plating/asteroid/basalt/lava_land_surface,
/area/ruin/unpowered)
"G" = (
/turf/closed/indestructible/riveted/boss/see_through,
/area/ruin/unpowered)
"H" = (
/obj/structure/necropolis_gate,
/obj/structure/stone_tile/block{
	dir = 4
	},
/obj/structure/stone_tile/block/cracked{
	dir = 8
	},
/obj/structure/fans/tiny/invisible,
/obj/effect/decal/cleanable/blood,
/turf/open/indestructible/boss,
/area/ruin/unpowered)
"I" = (
/obj/structure/stone_tile/slab/cracked,
/turf/template_noop,
/area/ruin/unpowered)
"J" = (
/obj/structure/fluff/divine/convertaltar,
/turf/open/floor/plating/asteroid/basalt/lava_land_surface,
/area/ruin/unpowered)
"K" = (
/mob/living/simple_animal/hostile/dark_wizard,
/turf/open/floor/plating/asteroid/basalt/lava_land_surface,
/area/ruin/unpowered)

(1,1,1) = {"
c
c
c
c
c
c
c
c
c
c
c
c
c
c
c
c
c
c
c
c
"}
(2,1,1) = {"
c
c
c
c
c
c
c
c
c
c
c
c
c
c
c
c
c
c
c
c
"}
(3,1,1) = {"
c
c
c
c
c
c
c
c
c
c
c
c
c
c
c
c
c
c
c
c
"}
(4,1,1) = {"
c
c
c
c
c
c
c
c
c
c
c
c
c
c
c
c
c
c
c
c
"}
(5,1,1) = {"
c
c
c
c
c
c
c
c
c
c
c
c
c
c
c
c
c
c
c
c
"}
(6,1,1) = {"
c
c
c
c
c
c
c
c
c
c
c
c
c
c
c
c
b
b
c
c
"}
(7,1,1) = {"
c
c
c
c
d
c
c
c
c
c
c
c
F
c
b
b
b
b
b
c
"}
(8,1,1) = {"
c
c
c
c
c
D
D
D
D
D
D
D
D
b
b
b
b
b
b
c
"}
(9,1,1) = {"
c
c
c
c
c
D
e
j
o
t
y
D
D
b
K
b
b
b
K
c
"}
(10,1,1) = {"
c
c
c
c
c
D
f
k
p
u
z
D
G
b
b
b
b
b
b
c
"}
(11,1,1) = {"
c
c
c
c
c
D
g
l
q
v
A
E
H
b
b
b
J
b
b
c
"}
(12,1,1) = {"
c
c
c
c
c
D
h
m
r
w
B
D
G
b
b
b
b
b
b
c
"}
(13,1,1) = {"
c
c
c
c
c
D
i
n
s
x
C
D
D
b
K
b
b
b
K
c
"}
(14,1,1) = {"
c
c
c
c
c
D
D
D
D
D
D
D
D
b
b
b
b
b
b
c
"}
(15,1,1) = {"
c
c
c
c
d
c
c
c
c
c
c
c
I
c
b
b
b
b
b
c
"}
(16,1,1) = {"
c
c
c
c
c
c
c
c
c
c
c
c
c
c
c
c
b
b
c
c
"}
(17,1,1) = {"
c
c
c
c
c
c
c
c
c
c
c
c
c
c
c
c
c
c
c
c
"}
(18,1,1) = {"
c
c
c
c
c
c
c
c
c
c
c
c
c
c
c
c
c
c
c
c
"}
(19,1,1) = {"
c
c
c
c
c
c
c
c
c
c
c
c
c
c
c
c
c
c
c
c
"}
(20,1,1) = {"
c
c
c
c
c
c
c
c
c
c
c
c
c
c
c
c
c
c
c
c
"}
