//MAP CONVERTED BY dmm2tgm.py THIS HEADER COMMENT PREVENTS RECONVERSION, DO NOT REMOVE
"a" = (
/turf/template_noop,
/area/template_noop)
"b" = (
/turf/closed/mineral/volcanic/lava_land_surface,
/area/overmap_encounter/planetoid/lava)
"c" = (
/turf/open/floor/plating/asteroid/basalt/lava_land_surface,
/area/overmap_encounter/planetoid/lava)
"d" = (
/obj/structure/stone_tile/block{
	dir = 8
	},
/turf/open/floor/plating/asteroid/basalt/lava_land_surface,
/area/overmap_encounter/planetoid/lava)
"e" = (
/obj/structure/stone_tile{
	dir = 8
	},
/turf/open/floor/plating/asteroid/basalt/lava_land_surface,
/area/overmap_encounter/planetoid/lava)
"f" = (
/obj/structure/stone_tile/cracked{
	dir = 1
	},
/turf/open/floor/plating/asteroid/basalt/lava_land_surface,
/area/overmap_encounter/planetoid/lava)
"g" = (
/obj/structure/stone_tile/cracked{
	dir = 8
	},
/turf/open/floor/plating/asteroid/basalt/lava_land_surface,
/area/overmap_encounter/planetoid/lava)
"h" = (
/obj/structure/stone_tile/block{
	dir = 4
	},
/turf/open/floor/plating/asteroid/basalt/lava_land_surface,
/area/overmap_encounter/planetoid/lava)
"i" = (
/obj/structure/stone_tile{
	dir = 4
	},
/turf/open/floor/plating/asteroid/basalt/lava_land_surface,
/area/overmap_encounter/planetoid/lava)
"j" = (
/obj/structure/stone_tile,
/turf/open/floor/plating/asteroid/basalt/lava_land_surface,
/area/overmap_encounter/planetoid/lava)
"k" = (
/obj/structure/stone_tile/cracked{
	dir = 4
	},
/turf/open/floor/plating/asteroid/basalt/lava_land_surface,
/area/overmap_encounter/planetoid/lava)
"l" = (
/obj/structure/stone_tile,
/obj/structure/stone_tile{
	dir = 4
	},
/turf/open/floor/plating/asteroid/basalt/lava_land_surface,
/area/overmap_encounter/planetoid/lava)
"m" = (
/obj/structure/stone_tile/cracked{
	dir = 8
	},
/obj/structure/stone_tile{
	dir = 1
	},
/turf/open/floor/plating/asteroid/basalt/lava_land_surface,
/area/overmap_encounter/planetoid/lava)
"n" = (
/obj/structure/stone_tile/block/cracked{
	dir = 4
	},
/turf/open/floor/plating/asteroid/basalt/lava_land_surface,
/area/overmap_encounter/planetoid/lava)
"o" = (
/obj/structure/stone_tile/block,
/turf/open/floor/plating/asteroid/basalt/lava_land_surface,
/area/overmap_encounter/planetoid/lava)
"p" = (
/obj/structure/stone_tile/block/cracked{
	dir = 1
	},
/turf/open/floor/plating/asteroid/basalt/lava_land_surface,
/area/overmap_encounter/planetoid/lava)
"q" = (
/obj/structure/stone_tile{
	dir = 4
	},
/obj/structure/stone_tile{
	dir = 1
	},
/turf/open/lava/smooth/lava_land_surface,
/area/overmap_encounter/planetoid/lava)
"r" = (
/obj/structure/stone_tile/block{
	dir = 1
	},
/turf/open/floor/plating/asteroid/basalt/lava_land_surface,
/area/overmap_encounter/planetoid/lava)
"s" = (
/obj/structure/stone_tile/block,
/obj/structure/stone_tile/cracked{
	dir = 4
	},
/turf/open/lava/smooth/lava_land_surface,
/area/overmap_encounter/planetoid/lava)
"t" = (
/obj/structure/stone_tile/surrounding/cracked{
	dir = 6
	},
/mob/living/simple_animal/hostile/megafauna/blood_drunk_miner{
	dir = 1
	},
/turf/open/lava/smooth/lava_land_surface,
/area/overmap_encounter/planetoid/lava)
"u" = (
/obj/structure/stone_tile{
	dir = 1
	},
/obj/structure/stone_tile/block/cracked,
/turf/open/lava/smooth/lava_land_surface,
/area/overmap_encounter/planetoid/lava)
"v" = (
/obj/structure/stone_tile{
	dir = 4
	},
/obj/structure/stone_tile/cracked,
/turf/open/floor/plating/asteroid/basalt/lava_land_surface,
/area/overmap_encounter/planetoid/lava)
"w" = (
/obj/structure/stone_tile,
/obj/structure/stone_tile/block/cracked{
	dir = 8
	},
/turf/open/lava/smooth/lava_land_surface,
/area/overmap_encounter/planetoid/lava)
"x" = (
/obj/structure/stone_tile{
	dir = 8
	},
/obj/structure/stone_tile/block{
	dir = 1
	},
/turf/open/floor/plating/asteroid/basalt/lava_land_surface,
/area/overmap_encounter/planetoid/lava)
"y" = (
/obj/structure/stone_tile/cracked,
/turf/open/floor/plating/asteroid/basalt/lava_land_surface,
/area/overmap_encounter/planetoid/lava)

(1,1,1) = {"
a
a
a
b
b
b
b
b
b
a
a
a
a
a
"}
(2,1,1) = {"
a
a
b
b
c
c
b
b
b
b
b
b
a
a
"}
(3,1,1) = {"
b
b
b
c
d
c
c
b
b
b
b
b
b
a
"}
(4,1,1) = {"
b
b
c
c
k
o
c
c
c
c
b
b
b
b
"}
(5,1,1) = {"
b
c
d
g
c
p
c
v
c
c
c
c
b
b
"}
(6,1,1) = {"
b
c
c
h
l
e
s
j
c
d
e
c
c
b
"}
(7,1,1) = {"
b
c
c
c
c
q
t
w
x
y
p
e
c
b
"}
(8,1,1) = {"
b
c
e
i
m
j
u
e
c
f
d
y
c
b
"}
(9,1,1) = {"
b
c
f
j
c
r
c
o
c
c
c
c
b
b
"}
(10,1,1) = {"
b
b
c
c
c
o
c
c
b
b
c
b
b
b
"}
(11,1,1) = {"
b
b
b
c
n
c
c
b
b
b
b
b
b
a
"}
(12,1,1) = {"
a
b
b
c
c
c
b
b
b
b
b
a
a
a
"}
(13,1,1) = {"
a
a
b
b
b
b
b
a
a
a
a
a
a
a
"}
