//MAP CONVERTED BY dmm2tgm.py THIS HEADER COMMENT PREVENTS RECONVERSION, DO NOT REMOVE
"a" = (
/turf/template_noop,
/area/template_noop)
"b" = (
/turf/closed/mineral/volcanic/lava_land_surface,
/area/overmap_encounter/planetoid/lava)
"c" = (
/obj/structure/stone_tile/surrounding_tile{
	dir = 4
	},
/turf/open/floor/plating/asteroid/basalt/lava_land_surface,
/area/overmap_encounter/planetoid/lava)
"d" = (
/obj/structure/stone_tile/block{
	dir = 1
	},
/turf/open/floor/plating/asteroid/basalt/lava_land_surface,
/area/overmap_encounter/planetoid/lava)
"e" = (
/obj/structure/stone_tile/surrounding_tile/cracked{
	dir = 1
	},
/turf/open/floor/plating/asteroid/basalt/lava_land_surface,
/area/overmap_encounter/planetoid/lava)
"f" = (
/turf/open/floor/plating/asteroid/basalt/lava_land_surface,
/area/overmap_encounter/planetoid/lava)
"g" = (
/obj/structure/stone_tile{
	dir = 4
	},
/turf/open/floor/plating/asteroid/basalt/lava_land_surface,
/area/overmap_encounter/planetoid/lava)
"h" = (
/obj/structure/stone_tile/block/cracked{
	dir = 8
	},
/turf/open/floor/plating/asteroid/basalt/lava_land_surface,
/area/overmap_encounter/planetoid/lava)
"i" = (
/obj/structure/stone_tile/surrounding_tile/cracked,
/turf/open/floor/plating/asteroid/basalt/lava_land_surface,
/area/overmap_encounter/planetoid/lava)
"j" = (
/obj/structure/stone_tile/block/cracked{
	dir = 4
	},
/turf/open/floor/plating/asteroid/basalt/lava_land_surface,
/area/overmap_encounter/planetoid/lava)
"k" = (
/obj/structure/stone_tile/surrounding_tile{
	dir = 8
	},
/turf/open/floor/plating/asteroid/basalt/lava_land_surface,
/area/overmap_encounter/planetoid/lava)
"l" = (
/obj/structure/stone_tile/surrounding_tile,
/turf/open/floor/plating/asteroid/basalt/lava_land_surface,
/area/overmap_encounter/planetoid/lava)
"m" = (
/obj/structure/stone_tile/cracked{
	dir = 4
	},
/turf/open/floor/plating/asteroid/basalt/lava_land_surface,
/area/overmap_encounter/planetoid/lava)
"n" = (
/obj/structure/stone_tile/block{
	dir = 4
	},
/turf/open/floor/plating/asteroid/basalt/lava_land_surface,
/area/overmap_encounter/planetoid/lava)
"o" = (
/obj/structure/stone_tile,
/obj/structure/stone_tile{
	dir = 1
	},
/obj/structure/stone_tile/cracked{
	dir = 8
	},
/turf/open/floor/plating/asteroid/basalt/lava_land_surface,
/area/overmap_encounter/planetoid/lava)
"p" = (
/obj/structure/stone_tile,
/obj/structure/stone_tile/block/cracked{
	dir = 1
	},
/turf/open/floor/plating/asteroid/basalt/lava_land_surface,
/area/overmap_encounter/planetoid/lava)
"q" = (
/obj/structure/stone_tile{
	dir = 8
	},
/obj/structure/stone_tile{
	dir = 1
	},
/turf/open/floor/plating/asteroid/basalt/lava_land_surface,
/area/overmap_encounter/planetoid/lava)
"s" = (
/mob/living/simple_animal/hostile/megafauna/blood_drunk_miner/guidance{
	dir = 8
	},
/turf/open/floor/plating/asteroid/basalt/lava_land_surface,
/area/overmap_encounter/planetoid/lava)
"t" = (
/obj/structure/stone_tile{
	dir = 1
	},
/obj/structure/stone_tile{
	dir = 4
	},
/obj/structure/stone_tile/cracked{
	dir = 8
	},
/turf/open/floor/plating/asteroid/basalt/lava_land_surface,
/area/overmap_encounter/planetoid/lava)
"u" = (
/obj/structure/stone_tile/surrounding_tile/cracked{
	dir = 4
	},
/turf/open/floor/plating/asteroid/basalt/lava_land_surface,
/area/overmap_encounter/planetoid/lava)
"v" = (
/obj/structure/stone_tile/block/cracked,
/turf/open/floor/plating/asteroid/basalt/lava_land_surface,
/area/overmap_encounter/planetoid/lava)
"w" = (
/obj/structure/stone_tile/block,
/turf/open/floor/plating/asteroid/basalt/lava_land_surface,
/area/overmap_encounter/planetoid/lava)
"x" = (
/obj/structure/stone_tile/block/cracked{
	dir = 1
	},
/turf/open/floor/plating/asteroid/basalt/lava_land_surface,
/area/overmap_encounter/planetoid/lava)
"y" = (
/obj/structure/stone_tile,
/turf/open/floor/plating/asteroid/basalt/lava_land_surface,
/area/overmap_encounter/planetoid/lava)
"z" = (
/obj/structure/stone_tile/surrounding_tile/cracked{
	dir = 8
	},
/turf/open/floor/plating/asteroid/basalt/lava_land_surface,
/area/overmap_encounter/planetoid/lava)
"A" = (
/obj/structure/stone_tile/cracked{
	dir = 8
	},
/turf/open/floor/plating/asteroid/basalt/lava_land_surface,
/area/overmap_encounter/planetoid/lava)
"M" = (
/obj/structure/stone_tile/block{
	dir = 8
	},
/obj/structure/stone_tile/cracked,
/turf/open/floor/plating/asteroid/basalt/lava_land_surface,
/area/overmap_encounter/planetoid/lava)

(1,1,1) = {"
a
a
b
b
b
b
a
b
b
a
a
a
a
a
a
"}
(2,1,1) = {"
a
b
b
b
b
b
b
b
b
b
b
a
a
a
a
"}
(3,1,1) = {"
b
b
c
h
k
f
f
f
k
f
b
b
a
a
a
"}
(4,1,1) = {"
b
b
d
c
l
f
f
f
v
f
b
b
b
a
a
"}
(5,1,1) = {"
b
b
e
i
m
k
f
u
w
f
f
b
b
b
a
"}
(6,1,1) = {"
a
b
f
f
f
o
M
q
w
f
f
f
f
b
b
"}
(7,1,1) = {"
b
b
b
f
f
p
s
t
f
f
q
n
A
f
b
"}
(8,1,1) = {"
b
b
g
f
c
q
t
q
k
x
f
z
d
f
b
"}
(9,1,1) = {"
a
b
f
j
n
j
f
e
n
y
f
n
y
b
b
"}
(10,1,1) = {"
a
b
b
f
f
f
f
f
f
b
b
f
f
b
b
"}
(11,1,1) = {"
a
a
b
b
b
b
b
b
b
b
b
b
b
b
a
"}
(12,1,1) = {"
a
a
a
b
b
b
b
b
b
a
a
b
b
a
a
"}
