//MAP CONVERTED BY dmm2tgm.py THIS HEADER COMMENT PREVENTS RECONVERSION, DO NOT REMOVE
"a" = (
/turf/closed/indestructible/rock/snow/ice/ore,
/area/icemoon/underground)
"d" = (
/turf/template_noop,
/area/template_noop)
"j" = (
/obj/effect/mob_spawn/human/miner/explorer,
/turf/open/indestructible/necropolis{
	initial_gas_mix = "ICEMOON_ATMOS"
	},
/area/icemoon/underground)
"q" = (
/mob/living/simple_animal/hostile/megafauna/wendigo,
/turf/open/indestructible/necropolis{
	initial_gas_mix = "ICEMOON_ATMOS"
	},
/area/icemoon/underground)
"z" = (
/obj/effect/landmark/portal_exit{
	id = "wendigo arena"
	},
/turf/open/indestructible/necropolis{
	initial_gas_mix = "ICEMOON_ATMOS"
	},
/area/icemoon/underground)
"K" = (
/obj/effect/landmark/portal_exit{
	id = "wendigo arena exit"
	},
/turf/open/indestructible/necropolis{
	initial_gas_mix = "ICEMOON_ATMOS"
	},
/area/icemoon/underground)
"N" = (
/turf/open/indestructible/necropolis{
	initial_gas_mix = "ICEMOON_ATMOS"
	},
/area/icemoon/underground)
"U" = (
/obj/item/paper/crumpled/bloody{
	info = "for your own sake, do not enter"
	},
/turf/open/indestructible/necropolis{
	initial_gas_mix = "ICEMOON_ATMOS"
	},
/area/icemoon/underground)
"V" = (
/obj/effect/portal/permanent/one_way{
	id = "wendigo arena"
	},
/turf/open/indestructible/necropolis{
	initial_gas_mix = "ICEMOON_ATMOS"
	},
/area/icemoon/underground)

(1,1,1) = {"
d
d
d
d
d
d
d
d
d
d
d
d
d
d
d
d
d
d
d
d
d
d
d
d
d
d
d
d
d
d
d
"}
(2,1,1) = {"
d
d
d
d
d
d
d
d
d
d
d
d
d
d
d
d
d
d
d
d
d
d
d
d
d
d
d
d
d
d
d
"}
(3,1,1) = {"
d
d
d
d
d
d
d
d
d
d
d
d
d
d
d
d
d
d
d
d
d
d
d
d
d
d
d
d
d
d
d
"}
(4,1,1) = {"
d
d
d
d
d
d
d
d
d
d
d
d
d
d
d
d
d
d
d
d
d
d
d
d
d
d
d
d
d
d
d
"}
(5,1,1) = {"
d
d
d
d
d
d
d
d
d
a
a
a
a
a
a
a
a
a
a
a
a
a
d
d
d
d
d
d
d
d
d
"}
(6,1,1) = {"
d
d
d
d
d
d
d
d
a
a
a
a
a
a
a
a
a
a
a
a
a
a
a
d
d
d
d
d
d
d
d
"}
(7,1,1) = {"
d
d
d
d
d
d
d
a
a
a
a
a
a
a
a
a
a
a
a
a
a
a
a
a
d
d
d
d
d
d
d
"}
(8,1,1) = {"
d
d
d
d
d
d
a
a
a
a
a
a
a
a
a
a
a
a
a
a
a
a
a
a
a
d
d
d
d
d
d
"}
(9,1,1) = {"
d
d
d
d
d
a
a
a
a
a
a
N
N
N
N
N
N
N
N
N
a
a
a
a
a
a
d
d
d
d
d
"}
(10,1,1) = {"
d
d
d
d
a
a
a
a
a
a
N
N
N
N
N
N
N
N
N
N
N
a
a
a
a
a
a
d
d
d
d
"}
(11,1,1) = {"
d
d
d
d
a
a
a
a
a
N
N
N
N
N
N
N
N
N
N
N
N
N
a
a
a
a
a
d
d
d
d
"}
(12,1,1) = {"
d
d
d
d
a
a
a
a
N
N
N
N
N
N
N
N
N
N
N
N
N
N
N
a
a
a
a
d
d
d
d
"}
(13,1,1) = {"
d
d
d
d
a
a
a
N
N
N
N
N
N
N
N
N
N
N
N
N
N
N
N
N
a
a
a
d
d
d
d
"}
(14,1,1) = {"
d
d
d
d
a
a
a
N
N
N
N
N
N
N
N
N
N
N
N
N
N
N
N
N
a
a
a
d
d
d
d
"}
(15,1,1) = {"
d
d
d
d
a
a
a
N
N
N
N
N
N
N
N
N
N
N
N
N
N
N
N
N
a
a
a
d
d
d
d
"}
(16,1,1) = {"
d
d
d
d
a
a
a
N
N
N
N
N
N
N
N
N
N
N
N
N
N
N
N
N
a
a
a
d
d
d
d
"}
(17,1,1) = {"
d
d
N
N
a
a
a
N
N
N
N
N
N
N
N
N
N
N
N
N
N
N
N
N
a
a
a
j
N
d
d
"}
(18,1,1) = {"
d
d
N
K
a
a
a
N
N
N
N
N
N
N
N
q
N
N
N
N
N
N
N
z
a
a
a
V
U
d
d
"}
(19,1,1) = {"
d
d
N
N
a
a
a
N
N
N
N
N
N
N
N
N
N
N
N
N
N
N
N
N
a
a
a
N
N
d
d
"}
(20,1,1) = {"
d
d
d
d
a
a
a
N
N
N
N
N
N
N
N
N
N
N
N
N
N
N
N
N
a
a
a
d
d
d
d
"}
(21,1,1) = {"
d
d
d
d
a
a
a
N
N
N
N
N
N
N
N
N
N
N
N
N
N
N
N
N
a
a
a
d
d
d
d
"}
(22,1,1) = {"
d
d
d
d
a
a
a
N
N
N
N
N
N
N
N
N
N
N
N
N
N
N
N
N
a
a
a
d
d
d
d
"}
(23,1,1) = {"
d
d
d
d
a
a
a
N
N
N
N
N
N
N
N
N
N
N
N
N
N
N
N
N
a
a
a
d
d
d
d
"}
(24,1,1) = {"
d
d
d
d
a
a
a
a
N
N
N
N
N
N
N
N
N
N
N
N
N
N
N
a
a
a
a
d
d
d
d
"}
(25,1,1) = {"
d
d
d
d
a
a
a
a
a
N
N
N
N
N
N
N
N
N
N
N
N
N
a
a
a
a
a
d
d
d
d
"}
(26,1,1) = {"
d
d
d
d
a
a
a
a
a
a
N
N
N
N
N
N
N
N
N
N
N
a
a
a
a
a
a
d
d
d
d
"}
(27,1,1) = {"
d
d
d
d
d
a
a
a
a
a
a
N
N
N
N
N
N
N
N
N
a
a
a
a
a
a
d
d
d
d
d
"}
(28,1,1) = {"
d
d
d
d
d
d
a
a
a
a
a
a
a
a
a
a
a
a
a
a
a
a
a
a
a
d
d
d
d
d
d
"}
(29,1,1) = {"
d
d
d
d
d
d
d
a
a
a
a
a
a
a
a
a
a
a
a
a
a
a
a
a
d
d
d
d
d
d
d
"}
(30,1,1) = {"
d
d
d
d
d
d
d
d
a
a
a
a
a
a
a
a
a
a
a
a
a
a
a
d
d
d
d
d
d
d
d
"}
(31,1,1) = {"
d
d
d
d
d
d
d
d
d
a
a
a
a
a
a
a
a
a
a
a
a
a
d
d
d
d
d
d
d
d
d
"}
(32,1,1) = {"
d
d
d
d
d
d
d
d
d
d
d
d
d
d
d
d
d
d
d
d
d
d
d
d
d
d
d
d
d
d
d
"}
(33,1,1) = {"
d
d
d
d
d
d
d
d
d
d
d
d
d
d
d
d
d
d
d
d
d
d
d
d
d
d
d
d
d
d
d
"}
(34,1,1) = {"
d
d
d
d
d
d
d
d
d
d
d
d
d
d
d
d
d
d
d
d
d
d
d
d
d
d
d
d
d
d
d
"}
(35,1,1) = {"
d
d
d
d
d
d
d
d
d
d
d
d
d
d
d
d
d
d
d
d
d
d
d
d
d
d
d
d
d
d
d
"}
