//MAP CONVERTED BY dmm2tgm.py THIS HEADER COMMENT PREVENTS RECONVERSION, DO NOT REMOVE
"ay" = (
/turf/open/floor/carpet,
/area/ruin/powered)
"aM" = (
/turf/open/floor/wood,
/area/ruin/powered)
"aP" = (
/obj/structure/dresser,
/turf/open/floor/wood,
/area/ruin/powered)
"aZ" = (
/obj/structure/sign/poster/ripped,
/turf/closed/wall/rust,
/area/overmap_encounter/planetoid/ice)
"bR" = (
/obj/machinery/light/small/broken{
	dir = 4
	},
/obj/structure/fluff/fokoff_sign,
/turf/template_noop,
/area/template_noop)
"bY" = (
/obj/structure/flora/stump,
/turf/template_noop,
/area/template_noop)
"cj" = (
/obj/structure/table,
/obj/item/reagent_containers/food/snacks/fishandchips,
/obj/effect/turf_decal/corner/black{
	dir = 1
	},
/obj/effect/turf_decal/corner/black{
	dir = 2
	},
/turf/open/floor/plasteel,
/area/ruin/powered)
"cB" = (
/obj/effect/decal/cleanable/blood,
/turf/open/floor/wood,
/area/ruin/powered)
"dh" = (
/obj/machinery/door/airlock/wood,
/obj/structure/barricade/wooden/crude/snow,
/turf/open/floor/wood,
/area/ruin/powered)
"fD" = (
/obj/structure/bed,
/obj/effect/decal/cleanable/blood/bubblegum,
/obj/item/bedsheet/random,
/turf/open/floor/wood,
/area/ruin/powered)
"gG" = (
/obj/structure/table/wood,
/obj/item/reagent_containers/food/snacks/sashimi{
	pixel_y = 10
	},
/obj/item/reagent_containers/food/drinks/mug/coco{
	pixel_x = -10
	},
/obj/item/reagent_containers/food/drinks/mug/coco{
	pixel_x = 10;
	pixel_y = -4
	},
/obj/effect/decal/cleanable/dirt,
/turf/open/floor/carpet,
/area/ruin/powered)
"hD" = (
/obj/effect/decal/cleanable/blood/gibs/limb,
/turf/open/floor/engine/cult,
/area/ruin/powered)
"hI" = (
/obj/item/reagent_containers/food/drinks/beer,
/turf/open/floor/plating/ice/icemoon,
/area/overmap_encounter/planetoid/ice)
"iz" = (
/obj/structure/fence/door/opened{
	dir = 8
	},
/turf/open/floor/plating/snowed/smoothed/icemoon,
/area/overmap_encounter/planetoid/ice)
"iB" = (
/turf/closed/mineral/snowmountain/icemoon,
/area/overmap_encounter/planetoid/ice)
"iW" = (
/turf/open/floor/plating/ice/icemoon,
/area/overmap_encounter/planetoid/ice)
"jk" = (
/obj/effect/decal/cleanable/dirt,
/turf/open/floor/wood,
/area/ruin/powered)
"jP" = (
/obj/machinery/light/small{
	dir = 4
	},
/turf/template_noop,
/area/template_noop)
"kl" = (
/obj/structure/sign/poster/official/nanotrasen_logo,
/turf/closed/wall,
/area/overmap_encounter/planetoid/ice)
"ks" = (
/obj/structure/flora/rock/icy,
/obj/effect/mob_spawn/human/corpse/assistant,
/turf/open/floor/plating/asteroid/snow/icemoon,
/area/overmap_encounter/planetoid/ice)
"la" = (
/obj/effect/decal/cleanable/blood/gibs/up,
/obj/effect/mob_spawn/human/corpse/assistant,
/mob/living/simple_animal/hostile/skeleton/eskimo{
	name = "Village Hunter"
	},
/turf/open/floor/plating/asteroid/snow/icemoon,
/area/overmap_encounter/planetoid/ice)
"lg" = (
/obj/structure/flora/grass/both,
/obj/effect/decal/remains/human,
/turf/open/floor/plating/asteroid/snow/icemoon,
/area/overmap_encounter/planetoid/ice)
"li" = (
/obj/structure/dresser,
/obj/effect/decal/cleanable/glass,
/turf/open/floor/wood,
/area/ruin/powered)
"lo" = (
/obj/effect/decal/cleanable/blood/tracks{
	dir = 4
	},
/obj/effect/decal/cleanable/blood/footprints{
	dir = 8
	},
/turf/open/floor/plating/asteroid/snow/icemoon,
/area/overmap_encounter/planetoid/ice)
"lK" = (
/obj/structure/flora/ausbushes/sparsegrass,
/turf/open/floor/plating/asteroid/snow/icemoon,
/area/overmap_encounter/planetoid/ice)
"mi" = (
/obj/effect/decal/remains/human,
/mob/living/simple_animal/hostile/construct/juggernaut/hostile{
	health = 450;
	maxHealth = 450;
	name = "Right Hand of the Elder"
	},
/turf/open/floor/engine/cult,
/area/ruin/powered)
"mI" = (
/obj/structure/flora/ausbushes/fullgrass,
/obj/structure/flora/grass/both,
/obj/structure/fence{
	dir = 8
	},
/turf/open/floor/plating/asteroid/snow/icemoon,
/area/overmap_encounter/planetoid/ice)
"nR" = (
/obj/structure/chair/sofa/left,
/turf/closed/mineral/snowmountain/cavern/icemoon,
/area/overmap_encounter/planetoid/ice)
"oB" = (
/obj/structure/table/wood,
/obj/structure/bedsheetbin/empty,
/obj/item/clothing/under/misc/pj/blue,
/obj/item/clothing/shoes/sneakers/white,
/turf/open/floor/wood,
/area/ruin/powered)
"oF" = (
/obj/structure/flora/rock/icy,
/turf/template_noop,
/area/template_noop)
"pj" = (
/obj/structure/flora/ausbushes/sparsegrass,
/turf/template_noop,
/area/template_noop)
"pH" = (
/obj/structure/sign/poster/official/work_for_a_future,
/turf/closed/wall/mineral/wood,
/area/ruin/powered)
"pI" = (
/obj/structure/flora/rock/pile/icy,
/turf/template_noop,
/area/template_noop)
"pP" = (
/obj/structure/chair/sofa/left{
	dir = 1
	},
/obj/effect/decal/cleanable/dirt,
/turf/open/floor/wood,
/area/ruin/powered)
"pV" = (
/obj/machinery/door/airlock/maintenance_hatch,
/turf/open/floor/plating,
/area/ruin/powered)
"rC" = (
/obj/structure/closet/secure_closet/freezer,
/obj/item/reagent_containers/food/snacks/carpmeat,
/obj/item/reagent_containers/food/snacks/carpmeat,
/obj/item/reagent_containers/food/snacks/carpmeat,
/obj/item/reagent_containers/food/condiment/pack/ketchup,
/obj/item/reagent_containers/food/condiment/pack/ketchup,
/obj/item/reagent_containers/food/condiment/pack/ketchup,
/obj/effect/turf_decal/corner/black{
	dir = 1
	},
/obj/effect/turf_decal/corner/black{
	dir = 2
	},
/turf/open/floor/plasteel,
/area/ruin/powered)
"sG" = (
/obj/effect/decal/cleanable/vomit,
/obj/structure/toilet{
	dir = 1
	},
/turf/open/floor/plating,
/area/ruin/powered)
"sY" = (
/obj/structure/sink/kitchen{
	dir = 4;
	pixel_x = -12
	},
/obj/effect/decal/cleanable/dirt,
/obj/effect/turf_decal/corner/black{
	dir = 1
	},
/obj/effect/turf_decal/corner/black{
	dir = 2
	},
/turf/open/floor/plasteel,
/area/ruin/powered)
"tg" = (
/obj/structure/fence{
	dir = 8
	},
/turf/open/floor/plating/asteroid/snow/icemoon,
/area/overmap_encounter/planetoid/ice)
"tt" = (
/obj/effect/decal/cleanable/dirt,
/turf/open/floor/plasteel/freezer,
/area/ruin/powered)
"tF" = (
/obj/structure/fence,
/turf/open/floor/plating/asteroid/snow/icemoon,
/area/overmap_encounter/planetoid/ice)
"tM" = (
/obj/structure/statue/snow/snowlegion{
	desc = "An off-putting snowman, something about it gives you a sense of dread instead of holiday cheer."
	},
/turf/open/floor/plating/asteroid/snow/icemoon,
/area/overmap_encounter/planetoid/ice)
"tX" = (
/obj/structure/table/wood,
/obj/structure/bedsheetbin,
/turf/open/floor/wood,
/area/ruin/powered)
"us" = (
/obj/effect/decal/cleanable/blood/splatter,
/obj/effect/decal/cleanable/blood/footprints{
	dir = 8
	},
/turf/open/floor/plating/asteroid/snow/icemoon,
/area/overmap_encounter/planetoid/ice)
"ut" = (
/obj/item/flashlight/lantern{
	on = 1
	},
/obj/effect/decal/cleanable/dirt,
/turf/open/floor/wood,
/area/ruin/powered)
"vi" = (
/obj/effect/decal/cleanable/blood/drip,
/obj/structure/fence/door,
/turf/open/floor/plating/asteroid/snow/icemoon,
/area/overmap_encounter/planetoid/ice)
"wQ" = (
/turf/closed/wall,
/area/ruin/powered)
"xq" = (
/turf/open/floor/plating/asteroid/snow/icemoon,
/area/overmap_encounter/planetoid/ice)
"xN" = (
/obj/structure/bed/dogbed{
	pixel_y = 14
	},
/obj/effect/decal/cleanable/dirt,
/turf/open/floor/carpet,
/area/ruin/powered)
"yb" = (
/obj/structure/chair/sofa/right{
	dir = 1
	},
/turf/open/floor/wood,
/area/ruin/powered)
"yS" = (
/obj/effect/decal/cleanable/blood/drip,
/turf/open/floor/plating/asteroid/snow/icemoon,
/area/overmap_encounter/planetoid/ice)
"zR" = (
/obj/machinery/door/airlock/wood,
/obj/effect/decal/cleanable/dirt,
/turf/open/floor/wood,
/area/ruin/powered)
"zT" = (
/turf/open/floor/plating/snowed/smoothed/icemoon,
/area/overmap_encounter/planetoid/ice)
"Ai" = (
/obj/structure/flora/rock/pile/icy,
/turf/open/floor/plating/asteroid/snow/icemoon,
/area/overmap_encounter/planetoid/ice)
"AG" = (
/obj/structure/showcase/machinery/tv,
/obj/effect/decal/cleanable/dirt,
/obj/machinery/light/broken{
	dir = 1
	},
/turf/open/floor/holofloor/wood,
/area/ruin/powered)
"AM" = (
/obj/effect/decal/cleanable/blood/gibs/down,
/obj/item/pickaxe,
/turf/open/floor/engine/cult,
/area/ruin/powered)
"AN" = (
/obj/structure/closet/cabinet,
/obj/item/restraints/legcuffs/beartrap,
/obj/item/restraints/legcuffs/beartrap,
/obj/item/reagent_containers/glass/bottle/venom,
/obj/item/reagent_containers/glass/bottle/curare,
/obj/item/kitchen/knife/combat/survival,
/obj/effect/decal/cleanable/dirt,
/obj/item/reagent_containers/food/snacks/meat/slab/human,
/obj/item/reagent_containers/food/snacks/meat/slab/human,
/obj/item/reagent_containers/food/snacks/meat/slab/human,
/turf/open/floor/wood,
/area/ruin/powered)
"Bq" = (
/obj/structure/flora/tree/pine,
/turf/open/floor/plating/asteroid/snow/icemoon,
/area/overmap_encounter/planetoid/ice)
"Cd" = (
/obj/structure/chair/comfy/brown{
	dir = 8
	},
/turf/open/floor/carpet,
/area/ruin/powered)
"Cl" = (
/obj/structure/sacrificealtar,
/obj/effect/decal/cleanable/blood/old,
/obj/item/kitchen/knife/bloodletter,
/turf/open/floor/engine/cult,
/area/ruin/powered)
"CN" = (
/obj/structure/flora/grass/brown,
/turf/template_noop,
/area/template_noop)
"Dm" = (
/obj/structure/flora/grass/brown,
/turf/open/floor/plating/asteroid/snow/icemoon,
/area/overmap_encounter/planetoid/ice)
"DI" = (
/obj/structure/closet/emcloset,
/obj/item/tank/internals/emergency_oxygen,
/obj/item/tank/internals/emergency_oxygen,
/obj/item/clothing/mask/breath/medical,
/obj/item/clothing/mask/breath/medical,
/obj/item/flashlight/lantern,
/turf/open/floor/plasteel/freezer,
/area/ruin/powered)
"DM" = (
/obj/structure/flora/bush,
/turf/open/floor/plating/asteroid/snow/icemoon,
/area/overmap_encounter/planetoid/ice)
"Ed" = (
/obj/machinery/door/airlock/wood,
/obj/effect/mapping_helpers/airlock/locked,
/obj/structure/barricade/wooden/crude,
/turf/open/floor/wood,
/area/ruin/powered)
"Ei" = (
/turf/closed/mineral/snowmountain/cavern/icemoon,
/area/overmap_encounter/planetoid/ice)
"EF" = (
/obj/effect/decal/cleanable/blood/gibs/torso,
/obj/effect/decal/remains/human,
/mob/living/simple_animal/hostile/construct/juggernaut/hostile{
	health = 450;
	maxHealth = 450;
	name = "Left Hand of the Elder"
	},
/turf/open/floor/engine/cult,
/area/ruin/powered)
"FR" = (
/obj/effect/decal/cleanable/blood/splatter,
/turf/open/floor/plating/snowed/smoothed/icemoon,
/area/overmap_encounter/planetoid/ice)
"Gr" = (
/obj/structure/closet/crate/trashcart,
/obj/effect/decal/cleanable/dirt,
/obj/item/trash/chips,
/obj/item/trash/semki{
	pixel_x = 8;
	pixel_y = -4
	},
/obj/item/clothing/neck/petcollar,
/turf/open/floor/plasteel/freezer,
/area/ruin/powered)
"Gy" = (
/obj/effect/decal/cleanable/dirt,
/obj/machinery/door/airlock/wood,
/turf/open/floor/plating,
/area/ruin/powered)
"GK" = (
/obj/item/clothing/head/bearpelt,
/obj/structure/table/wood,
/obj/item/reagent_containers/food/snacks/burger/fish,
/obj/item/reagent_containers/food/drinks/beer{
	pixel_x = -4
	},
/obj/item/reagent_containers/food/drinks/beer{
	pixel_x = 10;
	pixel_y = 6
	},
/turf/open/floor/wood,
/area/ruin/powered)
"Ha" = (
/obj/structure/mirror{
	broken = 1
	},
/turf/closed/wall/mineral/wood,
/area/ruin/powered)
"Hf" = (
/obj/effect/decal/cleanable/blood/drip,
/turf/open/floor/wood,
/area/ruin/powered)
"Hx" = (
/obj/structure/closet/cabinet,
/obj/item/clothing/under/rank/cargo/miner,
/obj/item/clothing/suit/hooded/wintercoat/miner,
/obj/item/clothing/shoes/winterboots,
/obj/item/card/id/mining,
/obj/effect/decal/cleanable/dirt,
/turf/open/floor/wood,
/area/ruin/powered)
"IA" = (
/obj/structure/fireplace{
	fuel_added = 1000;
	lit = 1
	},
/obj/effect/decal/cleanable/dirt,
/turf/open/floor/carpet,
/area/ruin/powered)
"Kd" = (
/obj/structure/flora/grass/green,
/turf/template_noop,
/area/template_noop)
"LZ" = (
/obj/structure/bed,
/obj/item/bedsheet/random,
/turf/open/floor/wood,
/area/ruin/powered)
"Nq" = (
/obj/effect/decal/cleanable/dirt,
/obj/structure/rack,
/obj/item/storage/bag/ore,
/obj/item/storage/toolbox/mechanical,
/turf/open/floor/plasteel/freezer,
/area/ruin/powered)
"Og" = (
/turf/template_noop,
/area/template_noop)
"Os" = (
/obj/structure/chair/comfy/brown{
	dir = 4
	},
/turf/open/floor/carpet,
/area/ruin/powered)
"Pp" = (
/obj/machinery/vending/snack/random,
/turf/open/floor/holofloor/wood,
/area/ruin/powered)
"PQ" = (
/obj/effect/decal/cleanable/blood/splatter,
/mob/living/simple_animal/hostile/illusion{
	deathmessage = "disperses into the air in a cloud of red mist, you feel slightly more at ease.";
	desc = "You can't quite make out what you're seeing.";
	faction = list("cult");
	health = 500;
	maxHealth = 500;
	melee_damage_lower = 10;
	melee_damage_upper = 30;
	name = "Village Elder"
	},
/turf/open/floor/engine/cult,
/area/ruin/powered)
"Qh" = (
/obj/structure/closet/crate/trashcart,
/obj/effect/decal/cleanable/dirt,
/obj/effect/decal/cleanable/blood,
/obj/item/bodypart/head,
/obj/item/bodypart/l_arm{
	pixel_x = -9;
	pixel_y = -9
	},
/obj/item/bodypart/l_leg,
/obj/item/bodypart/r_arm,
/obj/item/bodypart/r_leg{
	pixel_x = 8;
	pixel_y = 4
	},
/obj/item/bodypart/chest,
/obj/item/organ/heart,
/obj/item/multitool,
/turf/open/floor/plasteel/freezer,
/area/ruin/powered)
"Qt" = (
/obj/effect/decal/cleanable/blood/footprints{
	dir = 1
	},
/obj/item/restraints/legcuffs/beartrap{
	armed = 1
	},
/obj/structure/flora/grass/both,
/turf/open/floor/plating/asteroid/snow/icemoon,
/area/overmap_encounter/planetoid/ice)
"QR" = (
/turf/closed/wall/rust,
/area/ruin/powered)
"Rv" = (
/obj/structure/flora/grass/both,
/turf/template_noop,
/area/template_noop)
"RW" = (
/turf/open/floor/plating/asteroid/snow/ice/icemoon,
/area/overmap_encounter/planetoid/ice)
"Si" = (
/obj/structure/mirror,
/turf/closed/wall/mineral/wood,
/area/ruin/powered)
"Sk" = (
/obj/effect/decal/cleanable/blood/tracks,
/obj/effect/decal/cleanable/blood/footprints{
	dir = 1
	},
/turf/open/floor/plating/asteroid/snow/icemoon,
/area/overmap_encounter/planetoid/ice)
"SN" = (
/turf/open/floor/plasteel/freezer,
/area/ruin/powered)
"SZ" = (
/obj/machinery/door/airlock/wood,
/turf/open/floor/wood,
/area/ruin/powered)
"Tc" = (
/obj/structure/flora/ausbushes/fullgrass,
/turf/open/floor/plating/asteroid/snow/icemoon,
/area/overmap_encounter/planetoid/ice)
"TW" = (
/obj/structure/flora/ausbushes/fullgrass,
/obj/structure/flora/grass/both,
/turf/open/floor/plating/asteroid/snow/icemoon,
/area/overmap_encounter/planetoid/ice)
"UI" = (
/obj/machinery/washing_machine,
/obj/effect/decal/cleanable/blood,
/obj/item/reagent_containers/food/snacks/meat/slab/corgi,
/turf/open/floor/wood,
/area/ruin/powered)
"Vn" = (
/turf/closed/wall/mineral/wood,
/area/ruin/powered)
"Ws" = (
/obj/structure/fence/cut/medium{
	dir = 4
	},
/turf/open/floor/plating/asteroid/snow/icemoon,
/area/overmap_encounter/planetoid/ice)
"WH" = (
/obj/effect/decal/cleanable/dirt,
/obj/structure/bed,
/obj/item/bedsheet/cult,
/turf/open/floor/wood,
/area/ruin/powered)
"Xm" = (
/obj/structure/flora/ausbushes/fullgrass,
/turf/template_noop,
/area/template_noop)
"Ze" = (
/turf/closed/wall,
/area/overmap_encounter/planetoid/ice)
"Zx" = (
/obj/structure/chair/wood{
	dir = 4
	},
/turf/open/floor/plating/ice/icemoon,
/area/overmap_encounter/planetoid/ice)
"ZG" = (
/obj/effect/decal/cleanable/dirt,
/obj/structure/closet/cabinet,
/obj/item/clothing/suit/hooded/wintercoat,
/obj/item/clothing/shoes/winterboots,
/obj/item/clothing/under/suit/tan,
/turf/open/floor/wood,
/area/ruin/powered)

(1,1,1) = {"
Og
Og
Og
Og
Og
Og
Og
Og
Og
Og
Og
Og
Og
Og
Og
Og
Og
Og
Og
Og
Og
Og
Og
Og
Og
Og
Og
Og
"}
(2,1,1) = {"
Og
Og
Og
Og
Og
Og
Og
bR
Og
Og
Og
jP
Og
Og
Og
Rv
Og
Og
Og
Og
Og
Og
Og
Og
Og
Og
Og
Og
"}
(3,1,1) = {"
Og
Og
Og
Og
Og
Og
Og
aZ
pI
Og
Og
kl
Og
Og
Og
Og
Og
Og
pI
Og
Og
Og
Og
Og
bY
Og
Og
Og
"}
(4,1,1) = {"
Og
Og
Og
Og
Og
Og
Ei
Ze
iB
ks
Ei
Ze
Ei
Ei
Ei
Ei
Ei
Ei
Ei
Ei
Xm
Og
Og
Og
Og
Og
Og
Og
"}
(5,1,1) = {"
Og
Og
Og
Og
Og
Rv
Ei
Ei
Ei
FR
Ai
Ei
Ei
Vn
Vn
Vn
Ei
Ei
Ei
Ei
Ei
Ei
Ei
Og
Og
Og
Og
Og
"}
(6,1,1) = {"
Og
pI
Og
Og
bY
Ei
Ei
Ei
Ai
zT
zT
zT
Ei
Vn
UI
Vn
Vn
wQ
wQ
QR
QR
wQ
Ei
Ei
Og
Rv
Og
Og
"}
(7,1,1) = {"
Og
Og
oF
Og
Ei
Ei
Vn
Vn
Vn
Vn
xq
zT
Bq
pH
jk
tX
Vn
QR
DI
SN
Qh
wQ
Ei
Ei
oF
Og
Og
Og
"}
(8,1,1) = {"
Og
Og
Og
Og
Ei
Ei
Vn
cj
sY
Vn
xq
zT
Vn
Vn
jk
oB
Vn
wQ
DI
tt
Gr
QR
lg
Ei
Ei
Og
Og
Og
"}
(9,1,1) = {"
Og
Og
Og
Ei
Ei
la
Vn
rC
ut
Vn
tF
iz
Vn
AG
aM
yb
Vn
wQ
Nq
SN
QR
QR
xq
Ei
Ei
Og
Og
Og
"}
(10,1,1) = {"
Og
Og
Kd
Ei
Ei
lo
Ha
li
Hf
SZ
zT
zT
Vn
Pp
aM
pP
Vn
wQ
QR
pV
wQ
xq
Tc
Ei
Ei
Og
Og
Og
"}
(11,1,1) = {"
Og
Og
Og
Ei
Ei
lo
Vn
Hx
fD
Vn
yS
zT
Vn
Vn
SZ
Vn
Vn
xq
xq
zT
tg
Bq
xq
Ei
Ei
Og
Og
Og
"}
(12,1,1) = {"
Og
Og
Og
Ei
Ei
lo
Vn
Vn
Vn
Vn
xq
zT
xq
Bq
zT
Tc
DM
zT
zT
zT
Ws
xq
xq
Ei
Ei
Ei
Og
Og
"}
(13,1,1) = {"
Og
Og
Og
Ei
Ei
us
Sk
Qt
vi
xq
yS
zT
zT
zT
zT
xq
xq
zT
xq
Vn
Vn
Vn
Vn
Ei
Ei
Ei
pI
Og
"}
(14,1,1) = {"
Og
Og
Ei
Ei
Ei
Ei
Bq
lK
mI
xq
xq
xq
xq
xq
zT
xq
xq
zT
xq
Vn
LZ
AN
Vn
Ei
Ei
Ei
Og
Og
"}
(15,1,1) = {"
Og
Og
Ei
Vn
Vn
Vn
Vn
Vn
Vn
Vn
Vn
xq
zT
zT
zT
zT
zT
zT
zT
zR
cB
GK
Vn
Ei
Ei
bY
Og
Og
"}
(16,1,1) = {"
Og
Og
Ei
Vn
EF
hD
Si
aP
WH
ZG
Vn
xq
zT
Tc
xq
xq
xq
xq
xq
Vn
Vn
Vn
Vn
Ei
Ei
Og
Og
Og
"}
(17,1,1) = {"
Og
Og
Ei
Vn
Cl
PQ
Ed
jk
aM
aM
Vn
xq
zT
xq
xq
xq
Bq
xq
xq
xq
Gy
sG
Vn
Ei
Ei
Og
Og
Og
"}
(18,1,1) = {"
Og
Og
Ei
Vn
mi
AM
Vn
ay
Os
jk
dh
zT
zT
xq
xq
xq
xq
TW
xq
xq
Vn
Vn
Vn
Ei
Ei
Og
Og
Og
"}
(19,1,1) = {"
Og
Og
Ei
Vn
Vn
Vn
Vn
IA
gG
aM
Vn
xq
xq
xq
RW
Dm
xq
xq
tM
xq
xq
xq
Bq
Ei
Ei
Og
CN
Og
"}
(20,1,1) = {"
Og
Og
Ei
Ei
Ei
nR
Vn
xN
Cd
jk
Vn
TW
xq
RW
iW
RW
RW
xq
xq
xq
xq
xq
xq
Ei
Ei
Og
Og
Og
"}
(21,1,1) = {"
Og
Og
Og
pj
Ei
Ei
Vn
Vn
Vn
Vn
Vn
xq
Dm
RW
iW
iW
iW
RW
lK
xq
xq
DM
Ei
Ei
Ei
Og
Og
Og
"}
(22,1,1) = {"
Og
bY
Og
Og
Ei
Ei
Ei
Ei
Bq
xq
xq
xq
RW
iW
hI
Zx
iW
iW
RW
RW
xq
Ei
Ei
Ei
bY
Og
Og
Og
"}
(23,1,1) = {"
Og
Og
pI
Og
Og
Ei
Ei
Ei
Ei
DM
Tc
RW
RW
iW
iW
iW
iW
iW
iW
Ei
Ei
Ei
Ei
Og
Og
Og
Og
Og
"}
(24,1,1) = {"
Og
Og
Og
Og
Og
Og
Og
Ei
Ei
Ei
Ei
Ei
Ei
iW
iW
iW
iW
iW
Ei
Ei
Ei
Ei
pI
oF
Og
Og
Og
Og
"}
(25,1,1) = {"
Og
Og
Og
Og
Og
Og
Og
Ei
Ei
Ei
Ei
Ei
Ei
Ei
Ei
Ei
Ei
Ei
Ei
Ei
Ei
Og
Og
Og
Og
Og
Og
Og
"}
(26,1,1) = {"
Og
Og
Og
Og
Og
oF
Og
pI
Ei
Ei
Ei
Ei
Ei
Ei
Ei
Ei
Ei
Ei
Ei
Og
Og
Og
Og
Og
Og
Og
Og
Og
"}
(27,1,1) = {"
Og
Og
Og
Og
Og
Og
Og
Og
Og
Og
Og
Og
Og
pI
oF
Og
Og
Og
Og
Og
bY
Xm
Og
Og
Og
pI
Og
Og
"}
(28,1,1) = {"
Og
Og
Og
Og
Og
Og
Og
Og
Og
Og
Og
Og
Og
Og
Og
Og
Og
Og
Og
Og
Og
Og
Og
Og
Og
Og
Og
Og
"}
