//MAP CONVERTED BY dmm2tgm.py THIS HEADER COMMENT PREVENTS RECONVERSION, DO NOT REMOVE
"av" = (
/obj/structure/curtain/cloth/fancy,
/obj/structure/curtain/cloth/fancy,
/obj/effect/decal/cleanable/dirt/dust,
/turf/open/floor/carpet/red,
/area/ruin/unpowered)
"aC" = (
/obj/effect/decal/cleanable/dirt/dust,
/turf/open/floor/plating/snowed,
/area/ruin/unpowered)
"aV" = (
/obj/effect/decal/cleanable/dirt/dust,
/obj/effect/decal/cleanable/dirt/dust,
/mob/living/simple_animal/hostile/illusion{
	atmos_requirements = list("min_oxy" = 0, "max_oxy" = 0, "min_tox" = 0, "max_tox" = 0, "min_co2" = 0, "max_co2" = 0, "min_n2" = 0, "max_n2" = 0);
	deathmessage = "disperses into the aether, finally unbound to the material plane.";
	desc = "A spirit bound to protect something.";
	icon = 'icons/mob/mob.dmi';
	icon_living = "stand";
	icon_state = "stand";
	maxbodytemp = 5000;
	melee_damage_upper = 7;
	minbodytemp = 0;
	name = "guardian spirit";
	pressure_resistance = 100
	},
/turf/open/floor/wood,
/area/ruin/unpowered)
"bh" = (
/obj/effect/decal/cleanable/dirt/dust,
/turf/template_noop,
/area/template_noop)
"bF" = (
/obj/structure/chair/pew/right{
	dir = 1
	},
/obj/effect/turf_decal/snow,
/turf/open/floor/plasteel,
/area/ruin/unpowered)
"cl" = (
/obj/structure/table/wood,
/obj/item/reagent_containers/food/drinks/bottle/wine,
/obj/item/reagent_containers/food/drinks/bottle/holywater,
/turf/open/floor/wood,
/area/ruin/unpowered)
"cv" = (
/obj/effect/decal/cleanable/dirt/dust,
/obj/effect/decal/remains/human,
/obj/effect/decal/cleanable/dirt/dust,
/turf/open/floor/carpet/red,
/area/ruin/unpowered)
"cE" = (
/obj/effect/decal/cleanable/dirt/dust,
/turf/open/floor/carpet/red,
/area/ruin/unpowered)
"dT" = (
/obj/effect/turf_decal/snow,
/turf/open/floor/plating/snowed,
/area/ruin/unpowered)
"eh" = (
/obj/effect/decal/cleanable/dirt/dust,
/obj/effect/decal/remains/human,
/turf/open/floor/plasteel/dark/snowdin,
/area/ruin/unpowered)
"ep" = (
/obj/structure/chair/pew{
	dir = 1
	},
/turf/open/floor/plating/snowed,
/area/ruin/unpowered)
"eG" = (
/obj/structure/chair/pew/left{
	dir = 1
	},
/obj/effect/decal/cleanable/dirt/dust,
/obj/effect/decal/cleanable/dirt/dust,
/obj/effect/decal/cleanable/dirt/dust,
/obj/effect/decal/cleanable/dirt/dust,
/turf/open/floor/plasteel,
/area/ruin/unpowered)
"eJ" = (
/obj/structure/closet/cabinet,
/obj/item/storage/book/bible,
/obj/item/clothing/suit/hooded/chaplain_hoodie,
/obj/effect/decal/cleanable/dirt/dust,
/obj/effect/decal/cleanable/dirt/dust,
/obj/effect/decal/cleanable/dirt/dust,
/obj/item/reagent_containers/food/drinks/bottle/holywater,
/turf/open/floor/carpet/black,
/area/ruin/unpowered)
"fQ" = (
/obj/structure/table/wood,
/obj/item/candle/infinite,
/turf/open/floor/wood,
/area/ruin/unpowered)
"gG" = (
/obj/structure/closet/cabinet,
/obj/item/storage/book/bible,
/obj/item/clothing/suit/hooded/chaplain_hoodie,
/obj/effect/decal/cleanable/dirt/dust,
/obj/effect/decal/cleanable/dirt/dust,
/obj/item/reagent_containers/food/drinks/bottle/holywater,
/obj/item/book/granter/spell/random,
/turf/open/floor/carpet/black,
/area/ruin/unpowered)
"gT" = (
/obj/effect/turf_decal/snow,
/turf/open/floor/plating/snowed/smoothed,
/area/ruin/unpowered)
"hy" = (
/obj/effect/decal/cleanable/dirt/dust,
/obj/effect/decal/cleanable/dirt/dust,
/obj/effect/decal/cleanable/dirt/dust,
/turf/open/floor/carpet/red,
/area/ruin/unpowered)
"hO" = (
/obj/effect/decal/cleanable/dirt/dust,
/obj/effect/decal/cleanable/dirt/dust,
/turf/open/floor/plasteel,
/area/ruin/unpowered)
"hV" = (
/obj/structure/mineral_door/wood,
/obj/structure/barricade/wooden/snowed,
/turf/open/floor/wood,
/area/ruin/unpowered)
"iy" = (
/obj/structure/chair/pew/right{
	dir = 1
	},
/obj/effect/decal/cleanable/dirt/dust,
/obj/effect/turf_decal/snow,
/obj/effect/decal/cleanable/dirt/dust,
/turf/open/floor/plasteel,
/area/ruin/unpowered)
"iV" = (
/obj/effect/decal/cleanable/dirt/dust,
/obj/effect/decal/cleanable/dirt/dust{
	pixel_y = 8
	},
/obj/effect/decal/cleanable/dirt/dust,
/obj/effect/decal/cleanable/dirt/dust,
/turf/open/floor/carpet/red,
/area/ruin/unpowered)
"jd" = (
/obj/effect/decal/cleanable/dirt/dust,
/obj/effect/decal/cleanable/dirt/dust,
/mob/living/simple_animal/hostile/illusion{
	atmos_requirements = list("min_oxy" = 0, "max_oxy" = 0, "min_tox" = 0, "max_tox" = 0, "min_co2" = 0, "max_co2" = 0, "min_n2" = 0, "max_n2" = 0);
	deathmessage = "disperses into the aether, finally unbound to the material plane.";
	desc = "A spirit bound to protect something.";
	icon = 'icons/mob/mob.dmi';
	icon_living = "stand";
	icon_state = "stand";
	maxbodytemp = 5000;
	melee_damage_upper = 7;
	minbodytemp = 0;
	name = "guardian spirit";
	pressure_resistance = 100
	},
/turf/open/floor/carpet/red,
/area/ruin/unpowered)
"je" = (
/obj/structure/railing{
	dir = 8
	},
/obj/effect/turf_decal/corner/black/half{
	dir = 8
	},
/obj/effect/decal/cleanable/dirt/dust,
/obj/effect/decal/cleanable/dirt/dust,
/obj/effect/turf_decal/snow,
/turf/open/floor/plasteel,
/area/ruin/unpowered)
"jj" = (
/obj/structure/closet/cabinet,
/obj/item/clothing/gloves/plate/blue,
/obj/item/clothing/head/helmet/plate/crusader/blue,
/obj/item/clothing/suit/armor/plate/crusader/blue,
/obj/item/reagent_containers/food/drinks/bottle/holywater,
/obj/item/nullrod,
/obj/effect/decal/cleanable/dirt/dust,
/turf/open/floor/carpet/red,
/area/ruin/unpowered)
"kD" = (
/obj/effect/decal/remains/human,
/obj/effect/turf_decal/snow,
/turf/open/floor/plating/snowed,
/area/ruin/unpowered)
"kJ" = (
/obj/effect/decal/cleanable/dirt/dust,
/obj/structure/mineral_door/iron,
/obj/structure/barricade/wooden/snowed,
/turf/open/floor/carpet/red,
/area/ruin/unpowered)
"kN" = (
/obj/effect/decal/remains/human,
/turf/closed/wall/mineral/iron,
/area/ruin/unpowered)
"kP" = (
/obj/structure/chair/pew{
	dir = 1
	},
/obj/effect/decal/cleanable/dirt/dust,
/obj/effect/turf_decal/snow,
/turf/open/floor/plating/snowed/smoothed,
/area/ruin/unpowered)
"kR" = (
/obj/structure/chair/pew/left{
	dir = 1
	},
/obj/effect/decal/cleanable/dirt/dust,
/obj/effect/turf_decal/snow,
/obj/effect/decal/cleanable/dirt/dust,
/turf/open/floor/plasteel,
/area/ruin/unpowered)
"me" = (
/obj/item/candle/tribal_torch,
/turf/open/floor/plating/snowed/smoothed,
/area/ruin/unpowered)
"nM" = (
/obj/item/candle/tribal_torch,
/turf/open/floor/wood,
/area/ruin/unpowered)
"nN" = (
/obj/item/candle/tribal_torch,
/turf/open/floor/plasteel/dark/snowdin,
/area/ruin/unpowered)
"nV" = (
/obj/structure/chair/pew/left{
	dir = 1
	},
/obj/effect/decal/cleanable/dirt/dust,
/turf/open/floor/plating/snowed/smoothed,
/area/ruin/unpowered)
"oE" = (
/obj/item/candle/tribal_torch,
/obj/effect/decal/cleanable/dirt/dust,
/obj/effect/turf_decal/snow,
/obj/effect/decal/cleanable/dirt/dust,
/turf/open/floor/plasteel,
/area/ruin/unpowered)
"oJ" = (
/obj/structure/bed,
/obj/item/bedsheet/chaplain,
/obj/effect/decal/cleanable/dirt/dust,
/obj/effect/decal/cleanable/dirt/dust,
/turf/open/floor/carpet/black,
/area/ruin/unpowered)
"pA" = (
/obj/effect/decal/cleanable/dirt/dust,
/obj/effect/decal/cleanable/dirt/dust,
/obj/effect/decal/cleanable/dirt/dust,
/obj/effect/decal/cleanable/dirt/dust,
/turf/open/floor/carpet/red,
/area/ruin/unpowered)
"qj" = (
/obj/structure/curtain/cloth/fancy,
/obj/effect/decal/cleanable/dirt/dust,
/turf/open/floor/carpet/red,
/area/ruin/unpowered)
"qo" = (
/obj/item/candle/tribal_torch,
/obj/effect/turf_decal/snow,
/turf/open/floor/plasteel,
/area/ruin/unpowered)
"qG" = (
/obj/structure/table/wood,
/turf/open/floor/carpet/black,
/area/ruin/unpowered)
"qI" = (
/obj/structure/chair/pew{
	dir = 1
	},
/obj/effect/decal/cleanable/dirt/dust,
/obj/effect/decal/cleanable/dirt/dust,
/turf/open/floor/plasteel/dark/snowdin,
/area/ruin/unpowered)
"ra" = (
/obj/structure/chair/pew/left{
	dir = 1
	},
/obj/effect/turf_decal/snow,
/turf/open/floor/plasteel,
/area/ruin/unpowered)
"rj" = (
/turf/open/floor/carpet/black,
/area/ruin/unpowered)
"sj" = (
/obj/item/candle/tribal_torch,
/obj/effect/decal/cleanable/dirt/dust,
/obj/effect/turf_decal/snow,
/turf/open/floor/plasteel,
/area/ruin/unpowered)
"sp" = (
/obj/effect/decal/cleanable/dirt/dust,
/obj/effect/decal/cleanable/dirt/dust,
/obj/effect/turf_decal/snow,
/obj/item/candle/tribal_torch,
/turf/open/floor/wood,
/area/ruin/unpowered)
"sw" = (
/turf/closed/wall/mineral/iron,
/area/ruin/unpowered)
"sC" = (
/obj/structure/chair/pew/right{
	dir = 1
	},
/obj/effect/decal/cleanable/dirt/dust,
/obj/effect/decal/cleanable/dirt/dust,
/obj/effect/turf_decal/snow,
/turf/open/floor/plasteel,
/area/ruin/unpowered)
"sT" = (
/obj/effect/decal/remains/human,
/obj/effect/decal/cleanable/dirt/dust,
/turf/open/floor/carpet/red,
/area/ruin/unpowered)
"sV" = (
/obj/effect/decal/cleanable/dirt/dust,
/obj/effect/decal/cleanable/dirt/dust,
/turf/closed/wall/mineral/iron,
/area/ruin/unpowered)
"ti" = (
/obj/item/candle/tribal_torch,
/obj/effect/decal/cleanable/dirt/dust,
/obj/effect/decal/cleanable/dirt/dust,
/obj/effect/decal/cleanable/dirt/dust,
/turf/open/floor/plasteel,
/area/ruin/unpowered)
"tI" = (
/obj/effect/decal/cleanable/dirt/dust,
/obj/item/candle/tribal_torch,
/turf/open/floor/carpet/red,
/area/ruin/unpowered)
"tJ" = (
/turf/open/floor/plating/snowed/smoothed,
/area/ruin/unpowered)
"uB" = (
/obj/structure/closet/cabinet,
/obj/item/storage/book/bible,
/obj/item/clothing/suit/hooded/chaplain_hoodie,
/obj/effect/decal/cleanable/dirt/dust,
/obj/effect/decal/cleanable/dirt/dust,
/obj/item/reagent_containers/food/drinks/bottle/holywater,
/turf/open/floor/carpet/black,
/area/ruin/unpowered)
"vq" = (
/obj/structure/railing{
	dir = 8
	},
/obj/effect/turf_decal/corner/black/half{
	dir = 8
	},
/obj/item/candle/tribal_torch,
/turf/open/floor/plasteel,
/area/ruin/unpowered)
"vP" = (
/obj/structure/closet/cabinet,
/obj/item/storage/book/bible,
/obj/item/clothing/suit/hooded/chaplain_hoodie,
/obj/effect/decal/cleanable/dirt/dust,
/obj/item/reagent_containers/food/drinks/bottle/holywater,
/turf/open/floor/carpet/black,
/area/ruin/unpowered)
"vZ" = (
/obj/structure/chair/pew/right{
	dir = 1
	},
/obj/effect/turf_decal/snow,
/obj/effect/decal/cleanable/dirt/dust,
/turf/open/floor/plasteel,
/area/ruin/unpowered)
"wp" = (
/obj/structure/closet/cabinet,
/obj/item/clothing/head/helmet/chaplain/witchunter_hat,
/obj/item/clothing/suit/armor/riot/chaplain/witchhunter,
/obj/item/nullrod/scythe/talking/chainsword,
/obj/effect/decal/cleanable/dirt/dust,
/turf/open/floor/carpet/red,
/area/ruin/unpowered)
"wM" = (
/obj/structure/chair/pew/right{
	dir = 1
	},
/obj/effect/decal/cleanable/dirt/dust,
/obj/effect/decal/remains/human,
/obj/effect/turf_decal/snow,
/obj/effect/turf_decal/snow,
/turf/open/floor/plasteel,
/area/ruin/unpowered)
"wP" = (
/obj/structure/chair/pew{
	dir = 1
	},
/obj/effect/turf_decal/snow,
/turf/open/floor/plating/snowed,
/area/ruin/unpowered)
"wV" = (
/obj/structure/table/wood,
/obj/item/papercutter,
/obj/item/paper_bin,
/obj/item/pen/fountain/solgov,
/obj/effect/decal/cleanable/dirt/dust,
/turf/open/floor/carpet/black,
/area/ruin/unpowered)
"xd" = (
/mob/living/simple_animal/hostile/illusion{
	atmos_requirements = list("min_oxy" = 0, "max_oxy" = 0, "min_tox" = 0, "max_tox" = 0, "min_co2" = 0, "max_co2" = 0, "min_n2" = 0, "max_n2" = 0);
	deathmessage = "disperses into the aether, finally unbound to the material plane.";
	desc = "A spirit bound to protect something.";
	icon = 'icons/mob/mob.dmi';
	icon_living = "stand";
	icon_state = "stand";
	maxbodytemp = 5000;
	melee_damage_upper = 7;
	minbodytemp = 0;
	name = "guardian spirit";
	pressure_resistance = 100
	},
/turf/open/floor/wood,
/area/ruin/unpowered)
"xp" = (
/obj/effect/decal/remains/human,
/obj/effect/decal/cleanable/dirt,
/turf/open/floor/carpet/red,
/area/ruin/unpowered)
"xz" = (
/obj/structure/railing{
	dir = 6
	},
/obj/effect/turf_decal/corner/black/three_quarters,
/turf/open/floor/plasteel,
/area/ruin/unpowered)
"yd" = (
/obj/structure/mineral_door/wood,
/obj/effect/decal/cleanable/dirt/dust,
/turf/open/floor/carpet/black,
/area/ruin/unpowered)
"ym" = (
/obj/effect/turf_decal/snow,
/obj/effect/decal/cleanable/dirt/dust,
/turf/open/floor/plating/snowed,
/area/ruin/unpowered)
"yq" = (
/obj/item/candle/tribal_torch,
/obj/effect/decal/cleanable/dirt/dust,
/obj/effect/decal/cleanable/dirt/dust,
/turf/open/floor/plating/snowed,
/area/ruin/unpowered)
"zd" = (
/obj/effect/decal/cleanable/dirt/dust,
/obj/effect/decal/cleanable/dirt/dust,
/turf/open/floor/carpet/black,
/area/ruin/unpowered)
"zH" = (
/obj/effect/decal/cleanable/dirt/dust,
/obj/item/candle/tribal_torch,
/turf/open/floor/wood,
/area/ruin/unpowered)
"Ao" = (
/obj/structure/chair/pew/right{
	dir = 1
	},
/obj/effect/decal/remains/human,
/obj/effect/turf_decal/snow,
/obj/effect/decal/cleanable/dirt/dust,
/turf/open/floor/plating/snowed/smoothed,
/area/ruin/unpowered)
"Aw" = (
/obj/structure/chair/pew/right{
	dir = 1
	},
/turf/open/floor/plasteel/dark/snowdin,
/area/ruin/unpowered)
"AF" = (
/obj/effect/turf_decal/snow,
/turf/open/floor/plasteel,
/area/ruin/unpowered)
"AI" = (
/obj/structure/curtain/cloth/fancy,
/obj/effect/decal/cleanable/dirt/dust,
/obj/effect/decal/cleanable/dirt/dust,
/turf/open/floor/carpet/red,
/area/ruin/unpowered)
"AX" = (
/obj/structure/mineral_door/wood,
/obj/effect/decal/cleanable/dirt/dust,
/obj/effect/decal/cleanable/dirt/dust,
/turf/open/floor/carpet/black,
/area/ruin/unpowered)
"By" = (
/obj/effect/decal/cleanable/dirt/dust,
/turf/open/floor/wood,
/area/ruin/unpowered)
"BD" = (
/obj/structure/chair/pew/left{
	dir = 1
	},
/turf/open/floor/plasteel/dark/snowdin,
/area/ruin/unpowered)
"Cg" = (
/obj/structure/chair/pew{
	dir = 1
	},
/obj/effect/decal/cleanable/dirt/dust,
/turf/open/floor/plasteel,
/area/ruin/unpowered)
"Cj" = (
/turf/open/floor/plating/snowed,
/area/ruin/unpowered)
"CC" = (
/obj/structure/chair/wood/wings{
	dir = 1
	},
/obj/effect/turf_decal/snow,
/turf/open/floor/wood,
/area/ruin/unpowered)
"CH" = (
/obj/structure/chair/pew/left{
	dir = 1
	},
/obj/effect/decal/cleanable/dirt/dust,
/turf/open/floor/plating/snowed,
/area/ruin/unpowered)
"CQ" = (
/obj/effect/decal/cleanable/dirt/dust,
/mob/living/simple_animal/hostile/illusion{
	atmos_requirements = list("min_oxy" = 0, "max_oxy" = 0, "min_tox" = 0, "max_tox" = 0, "min_co2" = 0, "max_co2" = 0, "min_n2" = 0, "max_n2" = 0);
	deathmessage = "disperses into the aether, finally unbound to the material plane.";
	desc = "A spirit bound to protect something.";
	icon = 'icons/mob/mob.dmi';
	icon_living = "stand";
	icon_state = "stand";
	maxbodytemp = 5000;
	melee_damage_upper = 7;
	minbodytemp = 0;
	name = "guardian spirit";
	pressure_resistance = 100
	},
/turf/open/floor/plasteel,
/area/ruin/unpowered)
"FL" = (
/obj/structure/closet/cabinet,
/obj/item/storage/box/holy_grenades,
/obj/item/ammo_box/c38_box,
/obj/item/ammo_box/c38_box,
/obj/item/ammo_box/c38_box,
/obj/item/ammo_box/c38_box,
/obj/item/gun/ballistic/shotgun/winchester,
/obj/effect/decal/cleanable/dirt/dust,
/turf/open/floor/wood,
/area/ruin/unpowered)
"He" = (
/obj/structure/chair/pew/left{
	dir = 1
	},
/obj/effect/decal/cleanable/dirt/dust,
/turf/open/floor/plasteel/dark/snowdin,
/area/ruin/unpowered)
"Hh" = (
/obj/structure/chair/pew/left{
	dir = 1
	},
/turf/open/floor/plasteel,
/area/ruin/unpowered)
"HA" = (
/obj/structure/curtain/cloth/fancy,
/turf/open/floor/carpet/red,
/area/ruin/unpowered)
"If" = (
/obj/effect/decal/cleanable/dirt/dust,
/obj/effect/decal/cleanable/dirt/dust,
/obj/structure/closet/cabinet,
/obj/item/clothing/suit/hooded/bee_costume,
/obj/item/toy/plush/beeplushie,
/obj/item/melee/beesword,
/turf/open/floor/carpet/red,
/area/ruin/unpowered)
"Il" = (
/obj/effect/decal/cleanable/dirt/dust,
/turf/open/floor/carpet/black,
/area/ruin/unpowered)
"Iw" = (
/obj/effect/decal/cleanable/dirt/dust,
/obj/effect/decal/cleanable/dirt/dust,
/turf/template_noop,
/area/template_noop)
"Ix" = (
/obj/effect/decal/cleanable/dirt/dust,
/obj/effect/decal/cleanable/dirt/dust,
/turf/open/floor/plasteel/dark/snowdin,
/area/ruin/unpowered)
"IS" = (
/obj/effect/decal/cleanable/dirt/dust,
/obj/effect/turf_decal/snow,
/turf/open/floor/wood,
/area/ruin/unpowered)
"Jh" = (
/obj/effect/decal/cleanable/dirt/dust,
/obj/effect/decal/cleanable/dirt/dust,
/obj/effect/decal/cleanable/dirt/dust,
/turf/open/floor/plating/snowed,
/area/ruin/unpowered)
"Jj" = (
/obj/effect/decal/cleanable/dirt/dust,
/obj/effect/turf_decal/snow,
/turf/open/floor/plasteel,
/area/ruin/unpowered)
"Jn" = (
/obj/structure/railing{
	dir = 10
	},
/obj/effect/turf_decal/corner/black/three_quarters{
	dir = 1
	},
/obj/effect/decal/cleanable/dirt/dust,
/turf/open/floor/plasteel,
/area/ruin/unpowered)
"JT" = (
/turf/open/floor/wood,
/area/ruin/unpowered)
"KD" = (
/obj/effect/decal/cleanable/dirt/dust,
/obj/effect/decal/cleanable/dirt/dust,
/turf/open/floor/carpet/red,
/area/ruin/unpowered)
"Lh" = (
/obj/structure/chair/pew{
	dir = 1
	},
/obj/effect/decal/cleanable/dirt/dust,
/obj/effect/decal/cleanable/dirt/dust,
/turf/open/floor/plating/snowed,
/area/ruin/unpowered)
"Lv" = (
/obj/structure/railing,
/obj/effect/turf_decal/corner/black/half,
/obj/effect/decal/cleanable/dirt/dust,
/obj/effect/decal/remains/human,
/turf/open/floor/plasteel,
/area/ruin/unpowered)
"LS" = (
/obj/item/candle/tribal_torch,
/obj/effect/decal/remains/human,
/obj/effect/turf_decal/snow,
/turf/open/floor/plasteel,
/area/ruin/unpowered)
"LW" = (
/turf/template_noop,
/area/template_noop)
"Mu" = (
/obj/structure/railing,
/obj/effect/turf_decal/corner/black/half,
/obj/effect/decal/cleanable/dirt/dust,
/obj/item/clothing/under/costume/kilt/highlander,
/obj/item/clothing/head/beret/highlander,
/turf/open/floor/plasteel,
/area/ruin/unpowered)
"MC" = (
/obj/structure/chair/pew/right{
	dir = 1
	},
/turf/open/floor/plasteel,
/area/ruin/unpowered)
"Nm" = (
/obj/structure/railing{
	dir = 4
	},
/obj/effect/turf_decal/corner/black/half{
	dir = 4
	},
/obj/item/candle/tribal_torch,
/obj/effect/decal/cleanable/dirt/dust,
/turf/open/floor/plasteel,
/area/ruin/unpowered)
"Nw" = (
/obj/structure/table/wood,
/obj/item/storage/book/bible/syndicate,
/obj/effect/decal/cleanable/dirt/dust,
/obj/effect/decal/cleanable/dirt/dust,
/turf/open/floor/wood,
/area/ruin/unpowered)
"NK" = (
/turf/open/floor/plasteel/stairs{
	dir = 1
	},
/area/ruin/unpowered)
"Oi" = (
/obj/structure/chair/pew{
	dir = 1
	},
/obj/effect/decal/cleanable/dirt/dust,
/turf/open/floor/plating/snowed,
/area/ruin/unpowered)
"Ol" = (
/obj/structure/chair/pew/right{
	dir = 1
	},
/turf/open/floor/plating/snowed,
/area/ruin/unpowered)
"Pa" = (
/obj/item/candle/tribal_torch,
/obj/effect/turf_decal/snow,
/obj/effect/decal/cleanable/dirt/dust,
/turf/open/floor/plasteel,
/area/ruin/unpowered)
"Pl" = (
/obj/effect/decal/cleanable/dirt/dust,
/turf/open/floor/plating/snowed/smoothed,
/area/ruin/unpowered)
"PE" = (
/obj/structure/chair/pew/right{
	dir = 1
	},
/obj/effect/turf_decal/snow,
/obj/effect/decal/cleanable/dirt/dust,
/obj/effect/decal/cleanable/dirt/dust,
/obj/effect/decal/cleanable/dirt/dust,
/turf/open/floor/plasteel,
/area/ruin/unpowered)
"Qe" = (
/obj/effect/decal/cleanable/dirt/dust,
/obj/effect/decal/cleanable/dirt/dust,
/turf/open/floor/wood,
/area/ruin/unpowered)
"QP" = (
/obj/structure/railing,
/obj/effect/turf_decal/corner/black/half,
/turf/open/floor/plasteel,
/area/ruin/unpowered)
"Ry" = (
/obj/structure/chair/pew{
	dir = 1
	},
/obj/effect/turf_decal/snow,
/turf/open/floor/plasteel,
/area/ruin/unpowered)
"Se" = (
/obj/structure/railing{
	dir = 4
	},
/obj/effect/turf_decal/corner/black/half{
	dir = 4
	},
/obj/effect/decal/cleanable/dirt/dust,
/turf/open/floor/plasteel,
/area/ruin/unpowered)
"SU" = (
/obj/structure/chair/pew/left{
	dir = 1
	},
/obj/effect/decal/cleanable/dirt/dust,
/obj/effect/turf_decal/snow,
/turf/open/floor/plasteel,
/area/ruin/unpowered)
"Tc" = (
/obj/effect/decal/cleanable/dirt/dust,
/turf/closed/wall/mineral/iron,
/area/ruin/unpowered)
"Tf" = (
/obj/item/candle/tribal_torch,
/obj/effect/turf_decal/snow,
/obj/effect/decal/cleanable/dirt/dust,
/obj/effect/decal/cleanable/dirt/dust,
/turf/open/floor/plasteel,
/area/ruin/unpowered)
"TM" = (
/obj/item/candle/tribal_torch,
/obj/effect/decal/cleanable/dirt/dust,
/obj/effect/decal/cleanable/dirt/dust,
/obj/effect/decal/cleanable/dirt/dust,
/turf/open/floor/plating/snowed/smoothed,
/area/ruin/unpowered)
"TX" = (
/obj/structure/altar_of_gods,
/obj/item/storage/book/bible,
/obj/effect/decal/cleanable/dirt/dust,
/obj/effect/decal/remains/human,
/obj/item/reagent_containers/food/drinks/bottle/wine,
/obj/item/reagent_containers/food/drinks/bottle/holywater,
/obj/item/claymore/highlander,
/turf/open/floor/carpet/red,
/area/ruin/unpowered)
"Uo" = (
/obj/structure/chair/pew/left{
	dir = 1
	},
/obj/effect/decal/cleanable/dirt/dust,
/obj/effect/turf_decal/snow,
/turf/open/floor/plating/snowed,
/area/ruin/unpowered)
"Vv" = (
/turf/open/floor/carpet/red,
/area/ruin/unpowered)
"VE" = (
/obj/structure/chair/pew{
	dir = 1
	},
/obj/effect/decal/remains/human,
/turf/open/floor/plating/snowed,
/area/ruin/unpowered)
"Wi" = (
/obj/effect/decal/cleanable/dirt/dust,
/turf/open/floor/plasteel/stairs{
	dir = 1
	},
/area/ruin/unpowered)
"Wl" = (
/mob/living/simple_animal/hostile/illusion{
	atmos_requirements = list("min_oxy" = 0, "max_oxy" = 0, "min_tox" = 0, "max_tox" = 0, "min_co2" = 0, "max_co2" = 0, "min_n2" = 0, "max_n2" = 0);
	deathmessage = "disperses into the aether, finally unbound to the material plane.";
	desc = "A spirit bound to protect something.";
	icon = 'icons/mob/mob.dmi';
	icon_living = "stand";
	icon_state = "stand";
	maxbodytemp = 5000;
	melee_damage_upper = 7;
	minbodytemp = 0;
	name = "guardian spirit";
	pressure_resistance = 100
	},
/turf/open/floor/carpet/red,
/area/ruin/unpowered)
"Xa" = (
/obj/effect/decal/cleanable/dirt/dust,
/obj/effect/decal/cleanable/dirt/dust,
/obj/effect/turf_decal/snow,
/turf/open/floor/wood,
/area/ruin/unpowered)
"Xe" = (
/obj/effect/decal/remains/human,
/turf/open/floor/carpet/red,
/area/ruin/unpowered)
"Xn" = (
/obj/effect/decal/cleanable/dirt/dust,
/obj/effect/decal/cleanable/dirt/dust,
/turf/open/floor/plating/snowed,
/area/ruin/unpowered)
"Xs" = (
/obj/effect/decal/cleanable/dirt/dust,
/turf/open/floor/plasteel/dark/snowdin,
/area/ruin/unpowered)
"Xw" = (
/obj/effect/turf_decal/snow,
/turf/open/floor/wood,
/area/ruin/unpowered)
"XA" = (
/obj/effect/decal/cleanable/dirt/dust,
/mob/living/simple_animal/hostile/illusion{
	atmos_requirements = list("min_oxy" = 0, "max_oxy" = 0, "min_tox" = 0, "max_tox" = 0, "min_co2" = 0, "max_co2" = 0, "min_n2" = 0, "max_n2" = 0);
	deathmessage = "disperses into the aether, finally unbound to the material plane.";
	desc = "A spirit bound to protect something.";
	icon = 'icons/mob/mob.dmi';
	icon_living = "stand";
	icon_state = "stand";
	maxbodytemp = 5000;
	melee_damage_upper = 7;
	minbodytemp = 0;
	name = "guardian spirit";
	pressure_resistance = 100
	},
/turf/open/floor/plating/snowed,
/area/ruin/unpowered)
"XR" = (
/obj/effect/decal/cleanable/dirt/dust,
/mob/living/simple_animal/hostile/illusion{
	atmos_requirements = list("min_oxy" = 0, "max_oxy" = 0, "min_tox" = 0, "max_tox" = 0, "min_co2" = 0, "max_co2" = 0, "min_n2" = 0, "max_n2" = 0);
	deathmessage = "disperses into the aether, finally unbound to the material plane.";
	desc = "A spirit bound to protect something.";
	icon = 'icons/mob/mob.dmi';
	icon_living = "stand";
	icon_state = "stand";
	maxbodytemp = 5000;
	melee_damage_upper = 7;
	minbodytemp = 0;
	name = "guardian spirit";
	pressure_resistance = 100
	},
/turf/open/floor/carpet/red,
/area/ruin/unpowered)
"Yj" = (
/obj/effect/decal/cleanable/dirt/dust,
/obj/effect/decal/cleanable/dirt/dust,
/turf/open/floor/plating/snowed/smoothed,
/area/ruin/unpowered)
"Yn" = (
/obj/effect/decal/cleanable/dirt/dust,
/obj/effect/decal/remains/human,
/turf/open/floor/carpet/red,
/area/ruin/unpowered)
"YO" = (
/obj/structure/bed,
/obj/item/bedsheet/chaplain,
/obj/effect/decal/cleanable/dirt/dust,
/turf/open/floor/carpet/black,
/area/ruin/unpowered)
"YX" = (
/turf/open/floor/plasteel,
/area/ruin/unpowered)
"Ze" = (
/obj/effect/decal/cleanable/dirt/dust,
/obj/effect/decal/cleanable/dirt/dust,
/obj/effect/decal/cleanable/dirt/dust,
/turf/open/floor/wood,
/area/ruin/unpowered)
"ZA" = (
/obj/structure/chair/pew{
	dir = 1
	},
/obj/effect/decal/cleanable/dirt/dust,
/obj/effect/turf_decal/snow,
/turf/open/floor/plating/snowed,
/area/ruin/unpowered)
"ZS" = (
/obj/structure/chair/pew/right{
	dir = 1
	},
/obj/effect/decal/cleanable/dirt/dust,
/obj/effect/decal/cleanable/dirt/dust,
/turf/open/floor/plasteel,
/area/ruin/unpowered)
"ZT" = (
/obj/structure/railing{
	dir = 6
	},
/obj/effect/turf_decal/corner/black/three_quarters,
/obj/effect/turf_decal/snow,
/turf/open/floor/plasteel,
/area/ruin/unpowered)

(1,1,1) = {"
LW
LW
LW
LW
LW
LW
LW
LW
LW
LW
LW
LW
LW
LW
LW
LW
LW
LW
bh
LW
LW
LW
LW
LW
LW
LW
LW
LW
LW
LW
LW
LW
LW
LW
LW
LW
LW
LW
LW
LW
"}
(2,1,1) = {"
LW
LW
LW
LW
LW
LW
LW
LW
LW
LW
LW
LW
LW
LW
LW
LW
LW
LW
LW
LW
LW
LW
LW
LW
LW
LW
LW
LW
LW
LW
LW
LW
LW
LW
LW
LW
LW
LW
LW
LW
"}
(3,1,1) = {"
LW
LW
LW
LW
sw
sw
sw
sw
Tc
Tc
Tc
sw
sw
sw
sw
sw
sw
sw
sw
sw
sw
sw
sw
sw
sw
sw
sw
sw
Tc
Tc
Tc
Tc
sw
sw
kN
sw
bh
LW
LW
LW
"}
(4,1,1) = {"
LW
LW
LW
LW
sw
nM
IS
sV
gG
rj
sw
cE
Vv
Wl
HA
YX
YX
QP
Vv
Vv
CQ
Uo
gT
ra
tJ
BD
Cj
CH
Xs
He
Pl
nV
Ix
BD
AF
sw
LW
LW
LW
LW
"}
(5,1,1) = {"
LW
LW
LW
LW
sw
IS
IS
yd
zd
oJ
Tc
If
KD
cE
av
cE
Nm
ZT
cE
Vv
aC
ep
tJ
Oi
Jh
Lh
eh
Oi
aC
ZA
gT
Cg
Jj
qI
Jj
sV
LW
LW
LW
LW
"}
(6,1,1) = {"
LW
LW
LW
LW
sw
IS
IS
Tc
Tc
Tc
sV
tI
cE
XR
HA
cE
Wi
NK
Xe
XR
yq
MC
Tf
PE
ti
iy
qo
wM
nN
vZ
oE
sC
sj
Aw
Pa
sV
LW
LW
LW
LW
"}
(7,1,1) = {"
LW
LW
LW
LW
sw
Xa
IS
sw
eJ
zd
sV
Vv
KD
Vv
HA
cE
je
Jn
cE
KD
Vv
hy
cE
cE
cv
Xe
cE
cE
KD
Vv
cE
cE
cE
xp
cE
sV
bh
LW
LW
LW
"}
(8,1,1) = {"
LW
LW
LW
LW
sw
Xa
IS
yd
zd
YO
Tc
jj
KD
KD
qj
Yn
TX
Mu
KD
XR
cE
pA
cE
Yn
KD
cE
KD
cE
cE
sT
KD
hy
cE
KD
cE
kJ
bh
LW
LW
LW
"}
(9,1,1) = {"
LW
LW
LW
LW
sw
IS
IS
Tc
Tc
sw
Tc
cE
KD
KD
AI
cE
Se
xz
cE
Yn
cE
Vv
hy
iV
hy
cE
cE
KD
cE
hy
cE
Vv
cE
KD
cE
Tc
Iw
LW
LW
LW
"}
(10,1,1) = {"
LW
LW
LW
LW
sw
sp
IS
sV
uB
Il
Tc
tI
cE
jd
AI
Vv
NK
NK
cE
Wl
sj
SU
sj
eG
Tf
kR
me
Hh
yq
ra
TM
He
LS
BD
qo
Tc
bh
LW
LW
LW
"}
(11,1,1) = {"
LW
LW
LW
LW
sw
Qe
Qe
AX
zd
oJ
sV
wp
cE
Vv
AI
cE
vq
Jn
KD
cE
Pl
kP
Cj
ep
Yj
Ry
dT
VE
Cj
Ry
ym
wP
kD
ep
Cj
sw
LW
LW
LW
LW
"}
(12,1,1) = {"
LW
LW
LW
LW
sw
Qe
Xa
sV
Tc
sw
sw
KD
cE
XR
qj
YX
YX
Lv
cE
cE
XA
Ao
hO
Ol
Pl
ZS
Pl
iy
Xn
MC
tJ
bF
Cj
Aw
Cj
sw
LW
LW
LW
LW
"}
(13,1,1) = {"
LW
LW
LW
LW
sw
Qe
IS
Tc
vP
Il
sw
Ze
Tc
Tc
Tc
sw
sw
sw
sw
sw
sw
sw
sw
sw
sw
sw
sw
sw
sw
sw
sw
sw
sw
sw
sw
sw
LW
LW
LW
LW
"}
(14,1,1) = {"
LW
LW
LW
LW
sw
Xa
JT
yd
Il
YO
Tc
Qe
sV
FL
IS
fQ
JT
sw
LW
LW
LW
LW
LW
LW
LW
LW
LW
LW
LW
LW
LW
LW
LW
LW
LW
LW
LW
LW
LW
LW
"}
(15,1,1) = {"
LW
LW
LW
LW
sw
IS
Qe
Tc
sw
Tc
sV
Qe
Tc
Nw
zd
qG
CC
sw
LW
LW
LW
LW
LW
LW
LW
LW
LW
LW
LW
LW
LW
LW
LW
LW
LW
LW
LW
LW
LW
LW
"}
(16,1,1) = {"
LW
LW
LW
LW
sw
JT
aV
IS
IS
IS
IS
Qe
sw
cl
zd
wV
Xw
sw
LW
LW
LW
LW
LW
LW
LW
LW
LW
LW
LW
LW
LW
LW
LW
LW
LW
LW
LW
LW
LW
LW
"}
(17,1,1) = {"
LW
LW
LW
LW
sw
zH
By
Qe
IS
IS
zH
Qe
hV
IS
By
xd
Xw
sw
LW
LW
LW
LW
LW
LW
LW
LW
LW
LW
LW
LW
LW
LW
LW
LW
LW
LW
LW
LW
LW
LW
"}
(18,1,1) = {"
LW
LW
LW
LW
sw
sw
sw
sw
sw
sw
sw
sw
sw
Tc
sw
sw
sw
sw
LW
LW
LW
LW
LW
LW
LW
LW
LW
LW
LW
LW
LW
LW
LW
LW
LW
LW
LW
LW
LW
LW
"}
(19,1,1) = {"
LW
LW
LW
LW
LW
LW
LW
LW
LW
LW
LW
LW
LW
LW
LW
LW
LW
LW
LW
LW
LW
LW
LW
LW
LW
LW
LW
LW
LW
LW
LW
LW
LW
LW
LW
LW
LW
LW
LW
LW
"}
(20,1,1) = {"
LW
LW
LW
LW
LW
LW
LW
LW
LW
LW
LW
LW
LW
LW
LW
LW
LW
LW
LW
LW
LW
LW
LW
LW
LW
LW
LW
LW
LW
LW
LW
LW
LW
LW
LW
LW
LW
LW
LW
LW
"}
