//MAP CONVERTED BY dmm2tgm.py THIS HEADER COMMENT PREVENTS RECONVERSION, DO NOT REMOVE
"av" = (
/obj/structure/curtain/cloth/fancy,
/obj/structure/curtain/cloth/fancy,
/obj/effect/decal/cleanable/dirt/dust,
/turf/open/floor/carpet/red,
/area/icemoon)
"aC" = (
/obj/effect/decal/cleanable/dirt/dust,
/turf/open/floor/plating/snowed,
/area/icemoon)
"aV" = (
/obj/effect/decal/cleanable/dirt/dust,
/mob/living/simple_animal/hostile/guardian/punch,
/obj/item/candle/tribal_torch,
/turf/open/floor/wood,
/area/icemoon)
"bh" = (
/obj/effect/decal/cleanable/dirt/dust,
/turf/template_noop,
/area/template_noop)
"bF" = (
/obj/structure/chair/pew/right{
	dir = 1
	},
/obj/effect/turf_decal/snow,
/turf/open/floor/plasteel,
/area/icemoon)
"cl" = (
/obj/structure/table/wood,
/obj/item/reagent_containers/food/drinks/bottle/wine,
/obj/item/reagent_containers/food/drinks/bottle/holywater,
/turf/open/floor/wood,
/area/icemoon)
"cv" = (
/obj/effect/decal/cleanable/dirt/dust,
/obj/effect/decal/remains/human,
/obj/effect/decal/cleanable/dirt/dust,
/turf/open/floor/carpet/red,
/area/icemoon)
"cE" = (
/obj/effect/decal/cleanable/dirt/dust,
/turf/open/floor/carpet/red,
/area/icemoon)
"dT" = (
/obj/effect/turf_decal/snow,
/turf/open/floor/plating/snowed,
/area/icemoon)
"eh" = (
/obj/effect/decal/cleanable/dirt/dust,
/obj/effect/decal/remains/human,
/turf/open/floor/plasteel/dark/snowdin,
/area/icemoon)
"ep" = (
/obj/structure/chair/pew{
	dir = 1
	},
/turf/open/floor/plating/snowed,
/area/icemoon)
"eG" = (
/obj/structure/chair/pew/left{
	dir = 1
	},
/obj/effect/decal/cleanable/dirt/dust,
/obj/effect/decal/cleanable/dirt/dust,
/obj/effect/decal/cleanable/dirt/dust,
/obj/effect/decal/cleanable/dirt/dust,
/turf/open/floor/plasteel,
/area/icemoon)
"eJ" = (
/obj/structure/closet/cabinet,
/obj/item/storage/book/bible,
/obj/item/clothing/suit/hooded/chaplain_hoodie,
/obj/effect/decal/cleanable/dirt/dust,
/obj/effect/decal/cleanable/dirt/dust,
/obj/effect/decal/cleanable/dirt/dust,
/obj/item/reagent_containers/food/drinks/bottle/holywater,
/turf/open/floor/carpet/black,
/area/icemoon)
"fQ" = (
/obj/structure/table/wood,
/obj/item/candle/infinite,
/turf/open/floor/wood,
/area/icemoon)
"gG" = (
)
"gT" = (
/obj/effect/turf_decal/snow,
/turf/open/floor/plating/snowed/smoothed,
/area/icemoon)
"hy" = (
/obj/effect/decal/cleanable/dirt/dust,
/obj/effect/decal/cleanable/dirt/dust,
/obj/effect/decal/cleanable/dirt/dust,
/turf/open/floor/carpet/red,
/area/icemoon)
"hO" = (
/obj/effect/decal/cleanable/dirt/dust,
/obj/effect/decal/cleanable/dirt/dust,
/turf/open/floor/plasteel,
/area/icemoon)
"hV" = (
/obj/structure/mineral_door/wood,
/obj/structure/barricade/wooden/snowed,
/turf/open/floor/wood,
/area/icemoon)
"iy" = (
/obj/structure/chair/pew/right{
	dir = 1
	},
/obj/effect/decal/cleanable/dirt/dust,
/obj/effect/turf_decal/snow,
/obj/effect/decal/cleanable/dirt/dust,
/turf/open/floor/plasteel,
/area/icemoon)
"iV" = (
/obj/effect/decal/cleanable/dirt/dust,
/obj/effect/decal/cleanable/dirt/dust{
	pixel_y = 8
	},
/obj/effect/decal/cleanable/dirt/dust,
/obj/effect/decal/cleanable/dirt/dust,
/turf/open/floor/carpet/red,
/area/icemoon)
"jd" = (
/obj/effect/decal/cleanable/dirt/dust,
/mob/living/simple_animal/hostile/guardian/protector,
/turf/open/floor/carpet/red,
/area/icemoon)
"je" = (
/obj/structure/railing{
	dir = 8
	},
/obj/effect/turf_decal/corner/black/half{
	dir = 8
	},
/obj/effect/decal/cleanable/dirt/dust,
/obj/effect/decal/cleanable/dirt/dust,
/obj/effect/turf_decal/snow,
/turf/open/floor/plasteel,
/area/icemoon)
"jj" = (
/obj/structure/closet/cabinet,
/obj/item/clothing/gloves/plate/blue,
/obj/item/clothing/head/helmet/plate/crusader/blue,
/obj/item/clothing/suit/armor/plate/crusader/blue,
/obj/item/reagent_containers/food/drinks/bottle/holywater,
/obj/item/nullrod,
/obj/effect/decal/cleanable/dirt/dust,
/turf/open/floor/carpet/red,
/area/icemoon)
"kD" = (
/obj/effect/decal/remains/human,
/obj/effect/turf_decal/snow,
/turf/open/floor/plating/snowed,
/area/icemoon)
"kJ" = (
/obj/effect/decal/cleanable/dirt/dust,
/obj/structure/mineral_door/iron,
/obj/structure/barricade/wooden/snowed,
/turf/open/floor/carpet/red,
/area/icemoon)
"kN" = (
/obj/effect/decal/remains/human,
/turf/closed/wall/mineral/iron,
/area/icemoon)
"kP" = (
/obj/structure/chair/pew{
	dir = 1
	},
/obj/effect/decal/cleanable/dirt/dust,
/obj/effect/turf_decal/snow,
/turf/open/floor/plating/snowed/smoothed,
/area/icemoon)
"kR" = (
/obj/structure/chair/pew/left{
	dir = 1
	},
/obj/effect/decal/cleanable/dirt/dust,
/obj/effect/turf_decal/snow,
/obj/effect/decal/cleanable/dirt/dust,
/turf/open/floor/plasteel,
/area/icemoon)
"me" = (
/obj/item/candle/tribal_torch,
/turf/open/floor/plating/snowed/smoothed,
/area/icemoon)
"nM" = (
/obj/item/candle/tribal_torch,
/turf/open/floor/wood,
/area/icemoon)
"nN" = (
/obj/item/candle/tribal_torch,
/turf/open/floor/plasteel/dark/snowdin,
/area/icemoon)
"nV" = (
/obj/structure/chair/pew/left{
	dir = 1
	},
/obj/effect/decal/cleanable/dirt/dust,
/turf/open/floor/plating/snowed/smoothed,
/area/icemoon)
"ow" = (
/obj/effect/decal/cleanable/dirt/dust,
/mob/living/simple_animal/hostile/guardian/gravitokinetic,
/turf/open/floor/carpet/red,
/area/icemoon)
"oE" = (
/obj/item/candle/tribal_torch,
/obj/effect/decal/cleanable/dirt/dust,
/obj/effect/turf_decal/snow,
/obj/effect/decal/cleanable/dirt/dust,
/turf/open/floor/plasteel,
/area/icemoon)
"oJ" = (
/obj/structure/bed,
/obj/item/bedsheet/chaplain,
/obj/effect/decal/cleanable/dirt/dust,
/obj/effect/decal/cleanable/dirt/dust,
/turf/open/floor/carpet/black,
/area/icemoon)
"pA" = (
/obj/effect/decal/cleanable/dirt/dust,
/obj/effect/decal/cleanable/dirt/dust,
/obj/effect/decal/cleanable/dirt/dust,
/obj/effect/decal/cleanable/dirt/dust,
/turf/open/floor/carpet/red,
/area/icemoon)
"qj" = (
/obj/structure/curtain/cloth/fancy,
/obj/effect/decal/cleanable/dirt/dust,
/turf/open/floor/carpet/red,
/area/icemoon)
"qo" = (
/obj/item/candle/tribal_torch,
/obj/effect/turf_decal/snow,
/turf/open/floor/plasteel,
/area/icemoon)
"qG" = (
/obj/structure/table/wood,
/turf/open/floor/carpet/black,
/area/icemoon)
"qI" = (
/obj/structure/chair/pew{
	dir = 1
	},
/obj/effect/decal/cleanable/dirt/dust,
/obj/effect/decal/cleanable/dirt/dust,
/turf/open/floor/plasteel/dark/snowdin,
/area/icemoon)
"ra" = (
/obj/structure/chair/pew/left{
	dir = 1
	},
/obj/effect/turf_decal/snow,
/turf/open/floor/plasteel,
/area/icemoon)
"rj" = (
/turf/open/floor/carpet/black,
/area/icemoon)
"sj" = (
/obj/item/candle/tribal_torch,
/obj/effect/decal/cleanable/dirt/dust,
/obj/effect/turf_decal/snow,
/turf/open/floor/plasteel,
/area/icemoon)
"sp" = (
/obj/effect/decal/cleanable/dirt/dust,
/obj/effect/decal/cleanable/dirt/dust,
/obj/effect/turf_decal/snow,
/obj/item/candle/tribal_torch,
/turf/open/floor/wood,
/area/icemoon)
"sw" = (
/turf/closed/wall/mineral/iron,
/area/icemoon)
"sC" = (
/obj/structure/chair/pew/right{
	dir = 1
	},
/obj/effect/decal/cleanable/dirt/dust,
/obj/effect/decal/cleanable/dirt/dust,
/obj/effect/turf_decal/snow,
/turf/open/floor/plasteel,
/area/icemoon)
"sT" = (
/obj/effect/decal/remains/human,
/obj/effect/decal/cleanable/dirt/dust,
/turf/open/floor/carpet/red,
/area/icemoon)
"sV" = (
/obj/effect/decal/cleanable/dirt/dust,
/obj/effect/decal/cleanable/dirt/dust,
/turf/closed/wall/mineral/iron,
/area/icemoon)
"ti" = (
/obj/item/candle/tribal_torch,
/obj/effect/decal/cleanable/dirt/dust,
/obj/effect/decal/cleanable/dirt/dust,
/obj/effect/decal/cleanable/dirt/dust,
/turf/open/floor/plasteel,
/area/icemoon)
"tI" = (
/obj/effect/decal/cleanable/dirt/dust,
/obj/item/candle/tribal_torch,
/turf/open/floor/carpet/red,
/area/icemoon)
"tJ" = (
/turf/open/floor/plating/snowed/smoothed,
/area/icemoon)
"uB" = (
/obj/structure/closet/cabinet,
/obj/item/storage/book/bible,
/obj/item/clothing/suit/hooded/chaplain_hoodie,
/obj/effect/decal/cleanable/dirt/dust,
/obj/effect/decal/cleanable/dirt/dust,
/obj/item/reagent_containers/food/drinks/bottle/holywater,
/turf/open/floor/carpet/black,
/area/icemoon)
"vq" = (
/obj/structure/railing{
	dir = 8
	},
/obj/effect/turf_decal/corner/black/half{
	dir = 8
	},
/obj/item/candle/tribal_torch,
/turf/open/floor/plasteel,
/area/icemoon)
"vP" = (
/obj/structure/closet/cabinet,
/obj/item/storage/book/bible,
/obj/item/clothing/suit/hooded/chaplain_hoodie,
/obj/effect/decal/cleanable/dirt/dust,
/obj/item/reagent_containers/food/drinks/bottle/holywater,
/turf/open/floor/carpet/black,
/area/icemoon)
"vU" = (
/mob/living/simple_animal/hostile/guardian/gravitokinetic,
/obj/effect/decal/cleanable/dirt/dust,
/obj/effect/decal/cleanable/dirt/dust,
/turf/open/floor/carpet/red,
/area/icemoon)
"vZ" = (
/obj/structure/chair/pew/right{
	dir = 1
	},
/obj/effect/turf_decal/snow,
/obj/effect/decal/cleanable/dirt/dust,
/turf/open/floor/plasteel,
/area/icemoon)
"wp" = (
/obj/structure/closet/cabinet,
/obj/item/clothing/head/helmet/chaplain/witchunter_hat,
/obj/item/clothing/suit/armor/riot/chaplain/witchhunter,
/obj/item/nullrod/scythe/talking/chainsword,
/obj/effect/decal/cleanable/dirt/dust,
/turf/open/floor/carpet/red,
/area/icemoon)
"wM" = (
/obj/structure/chair/pew/right{
	dir = 1
	},
/obj/effect/decal/cleanable/dirt/dust,
/obj/effect/decal/remains/human,
/obj/effect/turf_decal/snow,
/obj/effect/turf_decal/snow,
/turf/open/floor/plasteel,
/area/icemoon)
"wP" = (
/obj/structure/chair/pew{
	dir = 1
	},
/obj/effect/turf_decal/snow,
/turf/open/floor/plating/snowed,
/area/icemoon)
"wV" = (
/obj/structure/table/wood,
/obj/item/papercutter,
/obj/item/paper_bin,
/obj/item/pen/fountain/solgov,
/obj/effect/decal/cleanable/dirt/dust,
/turf/open/floor/carpet/black,
/area/icemoon)
"xd" = (
/mob/living/simple_animal/hostile/guardian/punch,
/turf/open/floor/wood,
/area/icemoon)
"xp" = (
/obj/effect/decal/remains/human,
/obj/effect/decal/cleanable/dirt,
/turf/open/floor/carpet/red,
/area/icemoon)
"xz" = (
/obj/structure/railing{
	dir = 6
	},
/obj/effect/turf_decal/corner/black/three_quarters,
/turf/open/floor/plasteel,
/area/icemoon)
"yd" = (
/obj/structure/mineral_door/wood,
/obj/effect/decal/cleanable/dirt/dust,
/turf/open/floor/carpet/black,
/area/icemoon)
"ym" = (
/obj/effect/turf_decal/snow,
/obj/effect/decal/cleanable/dirt/dust,
/turf/open/floor/plating/snowed,
/area/icemoon)
"yq" = (
/obj/item/candle/tribal_torch,
/obj/effect/decal/cleanable/dirt/dust,
/obj/effect/decal/cleanable/dirt/dust,
/turf/open/floor/plating/snowed,
/area/icemoon)
"zd" = (
/obj/effect/decal/cleanable/dirt/dust,
/obj/effect/decal/cleanable/dirt/dust,
/turf/open/floor/carpet/black,
/area/icemoon)
"zH" = (
/obj/effect/decal/cleanable/dirt/dust,
/obj/item/candle/tribal_torch,
/turf/open/floor/wood,
/area/icemoon)
"Ao" = (
/obj/structure/chair/pew/right{
	dir = 1
	},
/obj/effect/decal/remains/human,
/obj/effect/turf_decal/snow,
/obj/effect/decal/cleanable/dirt/dust,
/turf/open/floor/plating/snowed/smoothed,
/area/icemoon)
"Aw" = (
/obj/structure/chair/pew/right{
	dir = 1
	},
/turf/open/floor/plasteel/dark/snowdin,
/area/icemoon)
"AF" = (
/obj/effect/turf_decal/snow,
/turf/open/floor/plasteel,
/area/icemoon)
"AI" = (
/obj/structure/curtain/cloth/fancy,
/obj/effect/decal/cleanable/dirt/dust,
/obj/effect/decal/cleanable/dirt/dust,
/turf/open/floor/carpet/red,
/area/icemoon)
"AX" = (
/obj/structure/mineral_door/wood,
/obj/effect/decal/cleanable/dirt/dust,
/obj/effect/decal/cleanable/dirt/dust,
/turf/open/floor/carpet/black,
/area/icemoon)
"Bn" = (
/mob/living/simple_animal/hostile/guardian/gravitokinetic,
/obj/effect/decal/cleanable/dirt/dust,
/turf/open/floor/carpet/red,
/area/icemoon)
"By" = (
/obj/effect/decal/cleanable/dirt/dust,
/turf/open/floor/wood,
/area/icemoon)
"BD" = (
/obj/structure/chair/pew/left{
	dir = 1
	},
/turf/open/floor/plasteel/dark/snowdin,
/area/icemoon)
"Cg" = (
/obj/structure/chair/pew{
	dir = 1
	},
/obj/effect/decal/cleanable/dirt/dust,
/turf/open/floor/plasteel,
/area/icemoon)
"Cj" = (
/turf/open/floor/plating/snowed,
/area/icemoon)
"CC" = (
/obj/structure/chair/wood/wings{
	dir = 1
	},
/obj/effect/turf_decal/snow,
/turf/open/floor/wood,
/area/icemoon)
"CH" = (
/obj/structure/chair/pew/left{
	dir = 1
	},
/obj/effect/decal/cleanable/dirt/dust,
/turf/open/floor/plating/snowed,
/area/icemoon)
"CQ" = (
/obj/effect/decal/cleanable/dirt/dust,
/mob/living/simple_animal/hostile/guardian/ranged,
/turf/open/floor/plasteel,
/area/icemoon)
"FL" = (
/obj/structure/closet/cabinet,
/obj/item/storage/box/holy_grenades,
/obj/item/ammo_box/c38_box,
/obj/item/ammo_box/c38_box,
/obj/item/ammo_box/c38_box,
/obj/item/ammo_box/c38_box,
/obj/item/gun/ballistic/shotgun/winchester,
/obj/effect/decal/cleanable/dirt/dust,
/turf/open/floor/wood,
/area/icemoon)
"He" = (
/obj/structure/chair/pew/left{
	dir = 1
	},
/obj/effect/decal/cleanable/dirt/dust,
/turf/open/floor/plasteel/dark/snowdin,
/area/icemoon)
"Hh" = (
/obj/structure/chair/pew/left{
	dir = 1
	},
/turf/open/floor/plasteel,
/area/icemoon)
"HA" = (
/obj/structure/curtain/cloth/fancy,
/turf/open/floor/carpet/red,
/area/icemoon)
"If" = (
/obj/effect/decal/cleanable/dirt/dust,
/obj/effect/decal/cleanable/dirt/dust,
/obj/structure/closet/cabinet,
/obj/item/clothing/suit/hooded/bee_costume,
/obj/item/toy/plush/beeplushie,
/obj/item/melee/beesword,
/turf/open/floor/carpet/red,
/area/icemoon)
"Il" = (
/obj/effect/decal/cleanable/dirt/dust,
/turf/open/floor/carpet/black,
/area/icemoon)
"Iw" = (
/obj/effect/decal/cleanable/dirt/dust,
/obj/effect/decal/cleanable/dirt/dust,
/turf/template_noop,
/area/template_noop)
"Ix" = (
/obj/effect/decal/cleanable/dirt/dust,
/obj/effect/decal/cleanable/dirt/dust,
/turf/open/floor/plasteel/dark/snowdin,
/area/icemoon)
"IS" = (
/obj/effect/decal/cleanable/dirt/dust,
/obj/effect/turf_decal/snow,
/turf/open/floor/wood,
/area/icemoon)
"Jh" = (
/obj/effect/decal/cleanable/dirt/dust,
/obj/effect/decal/cleanable/dirt/dust,
/obj/effect/decal/cleanable/dirt/dust,
/turf/open/floor/plating/snowed,
/area/icemoon)
"Jj" = (
/obj/effect/decal/cleanable/dirt/dust,
/obj/effect/turf_decal/snow,
/turf/open/floor/plasteel,
/area/icemoon)
"Jn" = (
/obj/structure/railing{
	dir = 10
	},
/obj/effect/turf_decal/corner/black/three_quarters{
	dir = 1
	},
/obj/effect/decal/cleanable/dirt/dust,
/turf/open/floor/plasteel,
/area/icemoon)
"JT" = (
/turf/open/floor/wood,
/area/icemoon)
"KD" = (
/obj/effect/decal/cleanable/dirt/dust,
/obj/effect/decal/cleanable/dirt/dust,
/turf/open/floor/carpet/red,
/area/icemoon)
"Lh" = (
/obj/structure/chair/pew{
	dir = 1
	},
/obj/effect/decal/cleanable/dirt/dust,
/obj/effect/decal/cleanable/dirt/dust,
/turf/open/floor/plating/snowed,
/area/icemoon)
"Lv" = (
/obj/structure/railing,
/obj/effect/turf_decal/corner/black/half,
/obj/effect/decal/cleanable/dirt/dust,
/obj/effect/decal/remains/human,
/turf/open/floor/plasteel,
/area/icemoon)
"LS" = (
/obj/item/candle/tribal_torch,
/obj/effect/decal/remains/human,
/obj/effect/turf_decal/snow,
/turf/open/floor/plasteel,
/area/icemoon)
"LW" = (
/turf/template_noop,
/area/template_noop)
"Mu" = (
/obj/structure/railing,
/obj/effect/turf_decal/corner/black/half,
/obj/effect/decal/cleanable/dirt/dust,
/obj/item/clothing/under/costume/kilt/highlander,
/obj/item/clothing/head/beret/highlander,
/turf/open/floor/plasteel,
/area/icemoon)
"MC" = (
/obj/structure/chair/pew/right{
	dir = 1
	},
/turf/open/floor/plasteel,
/area/icemoon)
"Nm" = (
/obj/structure/railing{
	dir = 4
	},
/obj/effect/turf_decal/corner/black/half{
	dir = 4
	},
/obj/item/candle/tribal_torch,
/obj/effect/decal/cleanable/dirt/dust,
/turf/open/floor/plasteel,
/area/icemoon)
"Nw" = (
/obj/structure/table/wood,
/obj/item/storage/book/bible/syndicate,
/obj/effect/decal/cleanable/dirt/dust,
/obj/effect/decal/cleanable/dirt/dust,
/turf/open/floor/wood,
/area/icemoon)
"Nz" = (
/mob/living/simple_animal/hostile/guardian/protector,
/turf/open/floor/carpet/red,
/area/icemoon)
"NK" = (
/turf/open/floor/plasteel/stairs{
	dir = 1
	},
/area/icemoon)
"Oi" = (
/obj/structure/chair/pew{
	dir = 1
	},
/obj/effect/decal/cleanable/dirt/dust,
/turf/open/floor/plating/snowed,
/area/icemoon)
"Ol" = (
/obj/structure/chair/pew/right{
	dir = 1
	},
/turf/open/floor/plating/snowed,
/area/icemoon)
"Pa" = (
/obj/item/candle/tribal_torch,
/obj/effect/turf_decal/snow,
/obj/effect/decal/cleanable/dirt/dust,
/turf/open/floor/plasteel,
/area/icemoon)
"Pl" = (
/obj/effect/decal/cleanable/dirt/dust,
/turf/open/floor/plating/snowed/smoothed,
/area/icemoon)
"PE" = (
/obj/structure/chair/pew/right{
	dir = 1
	},
/obj/effect/turf_decal/snow,
/obj/effect/decal/cleanable/dirt/dust,
/obj/effect/decal/cleanable/dirt/dust,
/obj/effect/decal/cleanable/dirt/dust,
/turf/open/floor/plasteel,
/area/icemoon)
"Qe" = (
/obj/effect/decal/cleanable/dirt/dust,
/obj/effect/decal/cleanable/dirt/dust,
/turf/open/floor/wood,
/area/icemoon)
"QP" = (
/obj/structure/railing,
/obj/effect/turf_decal/corner/black/half,
/turf/open/floor/plasteel,
/area/icemoon)
"Ry" = (
/obj/structure/chair/pew{
	dir = 1
	},
/obj/effect/turf_decal/snow,
/turf/open/floor/plasteel,
/area/icemoon)
"Se" = (
/obj/structure/railing{
	dir = 4
	},
/obj/effect/turf_decal/corner/black/half{
	dir = 4
	},
/obj/effect/decal/cleanable/dirt/dust,
/turf/open/floor/plasteel,
/area/icemoon)
"SU" = (
/obj/structure/chair/pew/left{
	dir = 1
	},
/obj/effect/decal/cleanable/dirt/dust,
/obj/effect/turf_decal/snow,
/turf/open/floor/plasteel,
/area/icemoon)
"Tc" = (
/obj/effect/decal/cleanable/dirt/dust,
/turf/closed/wall/mineral/iron,
/area/icemoon)
"Tf" = (
/obj/item/candle/tribal_torch,
/obj/effect/turf_decal/snow,
/obj/effect/decal/cleanable/dirt/dust,
/obj/effect/decal/cleanable/dirt/dust,
/turf/open/floor/plasteel,
/area/icemoon)
"TM" = (
/obj/item/candle/tribal_torch,
/obj/effect/decal/cleanable/dirt/dust,
/obj/effect/decal/cleanable/dirt/dust,
/obj/effect/decal/cleanable/dirt/dust,
/turf/open/floor/plating/snowed/smoothed,
/area/icemoon)
"TX" = (
/obj/structure/altar_of_gods,
/obj/item/storage/book/bible,
/obj/effect/decal/cleanable/dirt/dust,
/obj/effect/decal/remains/human,
/obj/item/reagent_containers/food/drinks/bottle/wine,
/obj/item/reagent_containers/food/drinks/bottle/holywater,
/obj/item/claymore/highlander,
/turf/open/floor/carpet/red,
/area/icemoon)
"Uo" = (
/obj/structure/chair/pew/left{
	dir = 1
	},
/obj/effect/decal/cleanable/dirt/dust,
/obj/effect/turf_decal/snow,
/turf/open/floor/plating/snowed,
/area/icemoon)
"Vv" = (
/turf/open/floor/carpet/red,
/area/icemoon)
"VE" = (
/obj/structure/chair/pew{
	dir = 1
	},
/obj/effect/decal/remains/human,
/turf/open/floor/plating/snowed,
/area/icemoon)
"Wi" = (
/obj/effect/decal/cleanable/dirt/dust,
/turf/open/floor/plasteel/stairs{
	dir = 1
	},
/area/icemoon)
"Wl" = (
/mob/living/simple_animal/hostile/guardian/gravitokinetic,
/turf/open/floor/carpet/red,
/area/icemoon)
"Xa" = (
/obj/effect/decal/cleanable/dirt/dust,
/obj/effect/decal/cleanable/dirt/dust,
/obj/effect/turf_decal/snow,
/turf/open/floor/wood,
/area/icemoon)
"Xe" = (
/obj/effect/decal/remains/human,
/turf/open/floor/carpet/red,
/area/icemoon)
"Xn" = (
/obj/effect/decal/cleanable/dirt/dust,
/obj/effect/decal/cleanable/dirt/dust,
/turf/open/floor/plating/snowed,
/area/icemoon)
"Xs" = (
/obj/effect/decal/cleanable/dirt/dust,
/turf/open/floor/plasteel/dark/snowdin,
/area/icemoon)
"Xw" = (
/obj/effect/turf_decal/snow,
/turf/open/floor/wood,
/area/icemoon)
"XA" = (
/mob/living/simple_animal/hostile/guardian/ranged,
/obj/effect/decal/cleanable/dirt/dust,
/turf/open/floor/plating/snowed,
/area/icemoon)
"XR" = (
/mob/living/simple_animal/hostile/guardian/protector,
/obj/effect/decal/cleanable/dirt/dust,
/turf/open/floor/carpet/red,
/area/icemoon)
"Yj" = (
/obj/effect/decal/cleanable/dirt/dust,
/obj/effect/decal/cleanable/dirt/dust,
/turf/open/floor/plating/snowed/smoothed,
/area/icemoon)
"Yn" = (
/obj/effect/decal/cleanable/dirt/dust,
/obj/effect/decal/remains/human,
/turf/open/floor/carpet/red,
/area/icemoon)
"YO" = (
/obj/structure/bed,
/obj/item/bedsheet/chaplain,
/obj/effect/decal/cleanable/dirt/dust,
/turf/open/floor/carpet/black,
/area/icemoon)
"YX" = (
/turf/open/floor/plasteel,
/area/icemoon)
"Ze" = (
/obj/effect/decal/cleanable/dirt/dust,
/obj/effect/decal/cleanable/dirt/dust,
/obj/effect/decal/cleanable/dirt/dust,
/turf/open/floor/wood,
/area/icemoon)
"ZA" = (
/obj/structure/chair/pew{
	dir = 1
	},
/obj/effect/decal/cleanable/dirt/dust,
/obj/effect/turf_decal/snow,
/turf/open/floor/plating/snowed,
/area/icemoon)
"ZS" = (
/obj/structure/chair/pew/right{
	dir = 1
	},
/obj/effect/decal/cleanable/dirt/dust,
/obj/effect/decal/cleanable/dirt/dust,
/turf/open/floor/plasteel,
/area/icemoon)
"ZT" = (
/obj/structure/railing{
	dir = 6
	},
/obj/effect/turf_decal/corner/black/three_quarters,
/obj/effect/turf_decal/snow,
/turf/open/floor/plasteel,
/area/icemoon)

(1,1,1) = {"
LW
LW
LW
LW
LW
LW
LW
LW
LW
LW
LW
LW
LW
LW
LW
LW
LW
LW
bh
LW
LW
LW
LW
LW
LW
LW
LW
LW
LW
LW
LW
LW
LW
LW
LW
LW
LW
LW
LW
gG
"}
(2,1,1) = {"
LW
LW
LW
LW
LW
LW
LW
LW
LW
LW
LW
LW
LW
LW
LW
LW
LW
LW
LW
LW
LW
LW
LW
LW
LW
LW
LW
LW
LW
LW
LW
LW
LW
LW
LW
LW
LW
LW
LW
LW
"}
(3,1,1) = {"
LW
LW
LW
LW
sw
sw
sw
sw
Tc
Tc
Tc
sw
sw
sw
sw
sw
sw
sw
sw
sw
sw
sw
sw
sw
sw
sw
sw
sw
Tc
Tc
Tc
Tc
sw
sw
kN
sw
bh
LW
LW
LW
"}
(4,1,1) = {"
LW
LW
LW
LW
sw
nM
IS
sV
uB
rj
sw
cE
Vv
Wl
HA
YX
YX
QP
Vv
Vv
CQ
Uo
gT
ra
tJ
BD
Cj
CH
Xs
He
Pl
nV
Ix
BD
AF
sw
LW
LW
LW
LW
"}
(5,1,1) = {"
LW
LW
LW
LW
sw
IS
IS
yd
zd
oJ
Tc
If
KD
cE
av
cE
Nm
ZT
cE
Vv
aC
ep
tJ
Oi
Jh
Lh
eh
Oi
aC
ZA
gT
Cg
Jj
qI
Jj
sV
LW
LW
LW
LW
"}
(6,1,1) = {"
LW
LW
LW
LW
sw
IS
IS
Tc
Tc
Tc
sV
tI
cE
cE
HA
cE
Wi
NK
Xe
XR
yq
MC
Tf
PE
ti
iy
qo
wM
nN
vZ
oE
sC
sj
Aw
Pa
sV
LW
LW
LW
LW
"}
(7,1,1) = {"
LW
LW
LW
LW
sw
Xa
IS
sw
eJ
zd
sV
Vv
KD
Wl
HA
cE
je
Jn
cE
KD
Vv
hy
cE
cE
cv
Xe
cE
cE
KD
Vv
cE
cE
cE
xp
cE
sV
bh
LW
LW
LW
"}
(8,1,1) = {"
LW
LW
LW
LW
sw
Xa
IS
yd
zd
YO
Tc
jj
KD
KD
qj
Yn
TX
Mu
KD
ow
jd
pA
cE
Yn
KD
cE
KD
cE
cE
sT
KD
hy
cE
KD
cE
kJ
bh
LW
LW
LW
"}
(9,1,1) = {"
LW
LW
LW
LW
sw
IS
IS
Tc
Tc
sw
Tc
cE
KD
vU
AI
cE
Se
xz
cE
Yn
cE
Vv
hy
iV
hy
cE
cE
KD
cE
hy
cE
Vv
cE
KD
cE
Tc
Iw
LW
LW
LW
"}
(10,1,1) = {"
LW
LW
LW
LW
sw
sp
IS
sV
uB
Il
Tc
tI
cE
KD
AI
Vv
NK
NK
cE
Nz
sj
SU
sj
eG
Tf
kR
me
Hh
yq
ra
TM
He
LS
BD
qo
Tc
bh
LW
LW
LW
"}
(11,1,1) = {"
LW
LW
LW
LW
sw
Qe
Qe
AX
zd
oJ
sV
wp
cE
Vv
AI
cE
vq
Jn
KD
cE
Pl
kP
Cj
ep
Yj
Ry
dT
VE
Cj
Ry
ym
wP
kD
ep
Cj
sw
LW
LW
LW
LW
"}
(12,1,1) = {"
LW
LW
LW
LW
sw
Qe
Xa
sV
Tc
sw
sw
KD
cE
Bn
qj
YX
YX
Lv
cE
cE
XA
Ao
hO
Ol
Pl
ZS
Pl
iy
Xn
MC
tJ
bF
Cj
Aw
Cj
sw
LW
LW
LW
LW
"}
(13,1,1) = {"
LW
LW
LW
LW
sw
Qe
IS
Tc
vP
Il
sw
Ze
Tc
Tc
Tc
sw
sw
sw
sw
sw
sw
sw
sw
sw
sw
sw
sw
sw
sw
sw
sw
sw
sw
sw
sw
sw
LW
LW
LW
LW
"}
(14,1,1) = {"
LW
LW
LW
LW
sw
Xa
JT
yd
Il
YO
Tc
Qe
sV
FL
IS
fQ
JT
sw
LW
LW
LW
LW
LW
LW
LW
LW
LW
LW
LW
LW
LW
LW
LW
LW
LW
LW
LW
LW
LW
LW
"}
(15,1,1) = {"
LW
LW
LW
LW
sw
IS
Qe
Tc
sw
Tc
sV
Qe
Tc
Nw
zd
qG
CC
sw
LW
LW
LW
LW
LW
LW
LW
LW
LW
LW
LW
LW
LW
LW
LW
LW
LW
LW
LW
LW
LW
LW
"}
(16,1,1) = {"
LW
LW
LW
LW
sw
JT
Qe
IS
IS
IS
IS
Qe
sw
cl
zd
wV
Xw
sw
LW
LW
LW
LW
LW
LW
LW
LW
LW
LW
LW
LW
LW
LW
LW
LW
LW
LW
LW
LW
LW
LW
"}
(17,1,1) = {"
LW
LW
LW
LW
sw
aV
By
Qe
IS
IS
zH
Qe
hV
IS
By
xd
Xw
sw
LW
LW
LW
LW
LW
LW
LW
LW
LW
LW
LW
LW
LW
LW
LW
LW
LW
LW
LW
LW
LW
LW
"}
(18,1,1) = {"
LW
LW
LW
LW
sw
sw
sw
sw
sw
sw
sw
sw
sw
Tc
sw
sw
sw
sw
LW
LW
LW
LW
LW
LW
LW
LW
LW
LW
LW
LW
LW
LW
LW
LW
LW
LW
LW
LW
LW
LW
"}
(19,1,1) = {"
LW
LW
LW
LW
LW
LW
LW
LW
LW
LW
LW
LW
LW
LW
LW
LW
LW
LW
LW
LW
LW
LW
LW
LW
LW
LW
LW
LW
LW
LW
LW
LW
LW
LW
LW
LW
LW
LW
LW
LW
"}
(20,1,1) = {"
LW
LW
LW
LW
LW
LW
LW
LW
LW
LW
LW
LW
LW
LW
LW
LW
LW
LW
LW
LW
LW
LW
LW
LW
LW
LW
LW
LW
LW
LW
LW
LW
LW
LW
LW
LW
LW
LW
LW
LW
"}
