//MAP CONVERTED BY dmm2tgm.py THIS HEADER COMMENT PREVENTS RECONVERSION, DO NOT REMOVE
"aF" = (
/obj/structure/curtain/cloth/fancy,
/obj/effect/decal/cleanable/dirt/dust,
/obj/effect/decal/cleanable/dirt/dust,
/turf/open/floor/carpet/red,
/area/icemoon)
"aN" = (
/obj/structure/chair/pew/right{
	dir = 1
	},
/obj/effect/decal/cleanable/dirt/dust,
/obj/effect/decal/cleanable/dirt/dust,
/turf/open/floor/plasteel,
/area/icemoon)
"bb" = (
/obj/structure/bed,
/obj/item/bedsheet/chaplain,
/obj/effect/decal/cleanable/dirt/dust,
/turf/open/floor/carpet/black,
/area/icemoon)
"bf" = (
/obj/structure/mineral_door/wood,
/obj/effect/decal/cleanable/dirt/dust,
/turf/open/floor/carpet/black,
/area/icemoon)
"cg" = (
/obj/structure/bed,
/obj/item/bedsheet/chaplain,
/obj/effect/decal/cleanable/dirt/dust,
/obj/effect/decal/cleanable/dirt/dust,
/turf/open/floor/carpet/black,
/area/icemoon)
"cQ" = (
/obj/item/candle/tribal_torch,
/obj/effect/turf_decal/snow,
/obj/effect/decal/cleanable/dirt/dust,
/obj/effect/decal/cleanable/dirt/dust,
/turf/open/floor/plasteel,
/area/icemoon)
"cU" = (
/obj/effect/decal/cleanable/dirt/dust,
/obj/effect/decal/cleanable/dirt/dust,
/obj/structure/closet/cabinet,
/obj/item/clothing/suit/hooded/bee_costume,
/obj/item/toy/plush/beeplushie,
/obj/item/melee/beesword,
/turf/open/floor/carpet/red,
/area/icemoon)
"de" = (
/obj/structure/chair/pew/right{
	dir = 1
	},
/obj/effect/decal/remains/human,
/obj/effect/turf_decal/snow,
/obj/effect/decal/cleanable/dirt/dust,
/turf/open/floor/plating/snowed/smoothed,
/area/icemoon)
"ed" = (
/obj/structure/chair/pew{
	dir = 1
	},
/obj/effect/decal/cleanable/dirt/dust,
/turf/open/floor/plating/snowed,
/area/icemoon)
"eR" = (
/obj/structure/chair/pew{
	dir = 1
	},
/obj/effect/turf_decal/snow,
/turf/open/floor/plating/snowed,
/area/icemoon)
"fD" = (
/mob/living/simple_animal/hostile/guardian/punch,
/turf/open/floor/wood,
/area/icemoon)
"fW" = (
/obj/effect/decal/cleanable/dirt/dust,
/obj/effect/turf_decal/snow,
/turf/open/floor/wood,
/area/icemoon)
"gh" = (
/obj/structure/chair/pew/left{
	dir = 1
	},
/obj/effect/decal/cleanable/dirt/dust,
/obj/effect/turf_decal/snow,
/turf/open/floor/plasteel,
/area/icemoon)
"gy" = (
/obj/structure/table/wood,
/turf/open/floor/carpet/black,
/area/icemoon)
"gH" = (
/obj/structure/railing,
/obj/effect/turf_decal/corner/black/half,
/obj/effect/decal/cleanable/dirt/dust,
/obj/effect/decal/remains/human,
/turf/open/floor/plasteel,
/area/icemoon)
"gV" = (
/obj/item/candle/tribal_torch,
/obj/effect/turf_decal/snow,
/obj/effect/decal/cleanable/dirt/dust,
/turf/open/floor/plasteel,
/area/icemoon)
"ha" = (
/obj/effect/decal/cleanable/dirt/dust,
/obj/item/candle/tribal_torch,
/turf/open/floor/wood,
/area/icemoon)
"hU" = (
/obj/structure/chair/pew/left{
	dir = 1
	},
/turf/open/floor/plasteel/dark/snowdin,
/area/icemoon)
"ic" = (
/turf/open/floor/carpet/red,
/area/icemoon)
"id" = (
/obj/structure/mineral_door/wood,
/obj/effect/decal/cleanable/dirt/dust,
/obj/effect/decal/cleanable/dirt/dust,
/turf/open/floor/carpet/black,
/area/icemoon)
"in" = (
/obj/effect/decal/cleanable/dirt/dust,
/obj/effect/decal/cleanable/dirt/dust,
/turf/open/floor/plating/snowed/smoothed,
/area/icemoon)
"iG" = (
/obj/effect/decal/cleanable/dirt/dust,
/turf/open/floor/plating/snowed/smoothed,
/area/icemoon)
"jj" = (
/obj/structure/chair/pew/left{
	dir = 1
	},
/obj/effect/decal/cleanable/dirt/dust,
/obj/effect/turf_decal/snow,
/turf/open/floor/plating/snowed,
/area/icemoon)
"jt" = (
/mob/living/simple_animal/hostile/guardian/gravitokinetic,
/obj/effect/decal/cleanable/dirt/dust,
/turf/open/floor/carpet/red,
/area/icemoon)
"jA" = (
/obj/effect/turf_decal/snow,
/turf/open/floor/plating/snowed/smoothed,
/area/icemoon)
"jM" = (
/obj/structure/chair/pew{
	dir = 1
	},
/obj/effect/decal/cleanable/dirt/dust,
/obj/effect/turf_decal/snow,
/turf/open/floor/plating/snowed,
/area/icemoon)
"kn" = (
/mob/living/simple_animal/hostile/guardian/protector,
/turf/open/floor/carpet/red,
/area/icemoon)
"kq" = (
/obj/structure/chair/pew/left{
	dir = 1
	},
/obj/effect/turf_decal/snow,
/turf/open/floor/plasteel,
/area/icemoon)
"lz" = (
/obj/structure/chair/wood/wings{
	dir = 1
	},
/obj/effect/turf_decal/snow,
/turf/open/floor/wood,
/area/icemoon)
"lL" = (
/obj/effect/decal/cleanable/dirt/dust,
/obj/effect/decal/cleanable/dirt/dust,
/obj/effect/decal/cleanable/dirt/dust,
/turf/open/floor/carpet/red,
/area/icemoon)
"lW" = (
/obj/effect/decal/cleanable/dirt/dust,
/obj/item/candle/tribal_torch,
/turf/open/floor/carpet/red,
/area/icemoon)
"me" = (
/obj/structure/closet/cabinet,
/obj/item/storage/box/holy_grenades,
/obj/item/ammo_box/c38_box,
/obj/item/ammo_box/c38_box,
/obj/item/ammo_box/c38_box,
/obj/item/ammo_box/c38_box,
/obj/item/gun/ballistic/shotgun/winchester,
/obj/effect/decal/cleanable/dirt/dust,
/turf/open/floor/wood,
/area/icemoon)
"mY" = (
/obj/effect/decal/remains/human,
/obj/effect/turf_decal/snow,
/turf/open/floor/plating/snowed,
/area/icemoon)
"nd" = (
/obj/structure/chair/pew/right{
	dir = 1
	},
/turf/open/floor/plasteel/dark/snowdin,
/area/icemoon)
"nF" = (
/obj/item/candle/tribal_torch,
/turf/open/floor/plasteel/dark/snowdin,
/area/icemoon)
"nL" = (
/obj/structure/railing{
	dir = 6
	},
/obj/effect/turf_decal/corner/black/three_quarters,
/obj/effect/turf_decal/snow,
/turf/open/floor/plasteel,
/area/icemoon)
"ob" = (
/obj/structure/chair/pew/right{
	dir = 1
	},
/obj/effect/decal/cleanable/dirt/dust,
/obj/effect/decal/cleanable/dirt/dust,
/obj/effect/turf_decal/snow,
/turf/open/floor/plasteel,
/area/icemoon)
"oI" = (
/obj/structure/chair/pew/left{
	dir = 1
	},
/obj/effect/decal/cleanable/dirt/dust,
/obj/effect/decal/cleanable/dirt/dust,
/obj/effect/decal/cleanable/dirt/dust,
/obj/effect/decal/cleanable/dirt/dust,
/turf/open/floor/plasteel,
/area/icemoon)
"oT" = (
/obj/effect/decal/cleanable/dirt/dust,
/obj/effect/decal/cleanable/dirt/dust,
/obj/effect/turf_decal/snow,
/turf/open/floor/wood,
/area/icemoon)
"pc" = (
/obj/effect/decal/remains/human,
/obj/effect/decal/cleanable/dirt,
/turf/open/floor/carpet/red,
/area/icemoon)
"pf" = (
/obj/effect/decal/cleanable/dirt/dust,
/obj/effect/decal/remains/human,
/obj/effect/decal/cleanable/dirt/dust,
/turf/open/floor/carpet/red,
/area/icemoon)
"pp" = (
/obj/effect/decal/cleanable/dirt/dust,
/obj/effect/turf_decal/snow,
/turf/open/floor/plasteel,
/area/icemoon)
"px" = (
/obj/effect/turf_decal/snow,
/turf/open/floor/plating/snowed,
/area/icemoon)
"pH" = (
/obj/structure/railing{
	dir = 8
	},
/obj/effect/turf_decal/corner/black/half{
	dir = 8
	},
/obj/effect/decal/cleanable/dirt/dust,
/obj/effect/decal/cleanable/dirt/dust,
/obj/effect/turf_decal/snow,
/turf/open/floor/plasteel,
/area/icemoon)
"pK" = (
/turf/closed/wall/mineral/iron,
/area/icemoon)
"pL" = (
/obj/effect/decal/cleanable/dirt/dust,
/obj/effect/decal/remains/human,
/turf/open/floor/plasteel/dark/snowdin,
/area/icemoon)
"qb" = (
/obj/item/candle/tribal_torch,
/obj/effect/decal/remains/human,
/obj/effect/turf_decal/snow,
/turf/open/floor/plasteel,
/area/icemoon)
"qe" = (
/obj/structure/chair/pew{
	dir = 1
	},
/obj/effect/turf_decal/snow,
/turf/open/floor/plasteel,
/area/icemoon)
"qg" = (
/obj/structure/curtain/cloth/fancy,
/obj/structure/curtain/cloth/fancy,
/obj/effect/decal/cleanable/dirt/dust,
/turf/open/floor/carpet/red,
/area/icemoon)
"qr" = (
/obj/structure/altar_of_gods,
/obj/item/storage/book/bible,
/obj/effect/decal/cleanable/dirt/dust,
/obj/effect/decal/remains/human,
/obj/item/reagent_containers/food/drinks/bottle/wine,
/obj/item/reagent_containers/food/drinks/bottle/holywater,
/obj/item/claymore/highlander,
/turf/open/floor/carpet/red,
/area/icemoon)
"qx" = (
/obj/effect/turf_decal/snow,
/turf/open/floor/plasteel,
/area/icemoon)
"qz" = (
/obj/effect/turf_decal/snow,
/turf/open/floor/wood,
/area/icemoon)
"rf" = (
/obj/structure/table/wood,
/obj/item/papercutter,
/obj/item/paper_bin,
/obj/item/pen/fountain/solgov,
/obj/effect/decal/cleanable/dirt/dust,
/turf/open/floor/carpet/black,
/area/icemoon)
"rr" = (
/obj/structure/chair/pew/right{
	dir = 1
	},
/obj/effect/turf_decal/snow,
/obj/effect/decal/cleanable/dirt/dust,
/obj/effect/decal/cleanable/dirt/dust,
/obj/effect/decal/cleanable/dirt/dust,
/turf/open/floor/plasteel,
/area/icemoon)
"rI" = (
/obj/effect/decal/cleanable/dirt/dust,
/turf/open/floor/plasteel/stairs{
	dir = 1
	},
/area/icemoon)
"rM" = (
/obj/structure/chair/pew/right{
	dir = 1
	},
/turf/open/floor/plating/snowed,
/area/icemoon)
"sc" = (
/mob/living/simple_animal/hostile/guardian/protector,
/obj/effect/decal/cleanable/dirt/dust,
/turf/open/floor/carpet/red,
/area/icemoon)
"sj" = (
/obj/structure/table/wood,
/obj/item/storage/book/bible/syndicate,
/obj/effect/decal/cleanable/dirt/dust,
/obj/effect/decal/cleanable/dirt/dust,
/turf/open/floor/wood,
/area/icemoon)
"so" = (
/mob/living/simple_animal/hostile/guardian/gravitokinetic,
/turf/open/floor/carpet/red,
/area/icemoon)
"tm" = (
/obj/effect/decal/cleanable/dirt/dust,
/obj/effect/decal/cleanable/dirt/dust,
/turf/closed/wall/mineral/iron,
/area/icemoon)
"tu" = (
/obj/structure/chair/pew/left{
	dir = 1
	},
/obj/effect/decal/cleanable/dirt/dust,
/obj/effect/turf_decal/snow,
/obj/effect/decal/cleanable/dirt/dust,
/turf/open/floor/plasteel,
/area/icemoon)
"tB" = (
/obj/structure/closet/cabinet,
/obj/item/storage/book/bible,
/obj/item/clothing/suit/hooded/chaplain_hoodie,
/obj/effect/decal/cleanable/dirt/dust,
/obj/effect/decal/cleanable/dirt/dust,
/obj/effect/decal/cleanable/dirt/dust,
/obj/item/reagent_containers/food/drinks/bottle/holywater,
/turf/open/floor/carpet/black,
/area/icemoon)
"uq" = (
/obj/effect/decal/cleanable/dirt/dust,
/obj/effect/decal/cleanable/dirt/dust,
/obj/effect/decal/cleanable/dirt/dust,
/turf/open/floor/plating/snowed,
/area/icemoon)
"uD" = (
/obj/effect/decal/cleanable/dirt/dust,
/obj/structure/mineral_door/iron,
/obj/structure/barricade/wooden/snowed,
/turf/open/floor/carpet/red,
/area/icemoon)
"uZ" = (
/obj/effect/decal/cleanable/dirt/dust,
/turf/closed/wall/mineral/iron,
/area/icemoon)
"ve" = (
/obj/structure/closet/cabinet,
/obj/item/storage/book/bible,
/obj/item/clothing/suit/hooded/chaplain_hoodie,
/obj/effect/decal/cleanable/dirt/dust,
/obj/item/reagent_containers/food/drinks/bottle/holywater,
/turf/open/floor/carpet/black,
/area/icemoon)
"vq" = (
/obj/structure/railing,
/obj/effect/turf_decal/corner/black/half,
/turf/open/floor/plasteel,
/area/icemoon)
"wl" = (
/obj/item/candle/tribal_torch,
/obj/effect/decal/cleanable/dirt/dust,
/obj/effect/decal/cleanable/dirt/dust,
/obj/effect/decal/cleanable/dirt/dust,
/turf/open/floor/plasteel,
/area/icemoon)
"wJ" = (
/obj/effect/decal/remains/human,
/obj/effect/decal/cleanable/dirt/dust,
/turf/open/floor/carpet/red,
/area/icemoon)
"wP" = (
/obj/structure/curtain/cloth/fancy,
/obj/effect/decal/cleanable/dirt/dust,
/turf/open/floor/carpet/red,
/area/icemoon)
"wT" = (
/obj/structure/chair/pew/right{
	dir = 1
	},
/obj/effect/decal/cleanable/dirt/dust,
/obj/effect/turf_decal/snow,
/obj/effect/decal/cleanable/dirt/dust,
/turf/open/floor/plasteel,
/area/icemoon)
"wV" = (
/obj/structure/railing{
	dir = 10
	},
/obj/effect/turf_decal/corner/black/three_quarters{
	dir = 1
	},
/obj/effect/decal/cleanable/dirt/dust,
/turf/open/floor/plasteel,
/area/icemoon)
"xB" = (
/obj/item/candle/tribal_torch,
/turf/open/floor/wood,
/area/icemoon)
"yt" = (
/obj/effect/decal/cleanable/dirt/dust,
/mob/living/simple_animal/hostile/guardian/ranged,
/turf/open/floor/plasteel,
/area/icemoon)
"yU" = (
/obj/effect/decal/cleanable/dirt/dust,
/obj/effect/decal/cleanable/dirt/dust,
/turf/open/floor/carpet/black,
/area/icemoon)
"yX" = (
/turf/template_noop,
/area/template_noop)
"zP" = (
/obj/structure/curtain/cloth/fancy,
/turf/open/floor/carpet/red,
/area/icemoon)
"zT" = (
/obj/effect/decal/cleanable/dirt/dust,
/obj/effect/decal/cleanable/dirt/dust,
/turf/open/floor/plasteel,
/area/icemoon)
"AJ" = (
/obj/structure/table/wood,
/obj/item/reagent_containers/food/drinks/bottle/wine,
/obj/item/reagent_containers/food/drinks/bottle/holywater,
/turf/open/floor/wood,
/area/icemoon)
"Bf" = (
/obj/effect/decal/cleanable/dirt/dust,
/obj/effect/decal/cleanable/dirt/dust,
/turf/open/floor/carpet/red,
/area/icemoon)
"Bn" = (
/obj/structure/chair/pew{
	dir = 1
	},
/turf/open/floor/plating/snowed,
/area/icemoon)
"BB" = (
/turf/open/floor/carpet/black,
/area/icemoon)
"CH" = (
/obj/effect/decal/cleanable/dirt/dust,
/mob/living/simple_animal/hostile/guardian/protector,
/turf/open/floor/carpet/red,
/area/icemoon)
"Dh" = (
/obj/effect/decal/cleanable/dirt/dust,
/turf/open/floor/carpet/red,
/area/icemoon)
"Di" = (
/obj/structure/chair/pew/left{
	dir = 1
	},
/obj/effect/decal/cleanable/dirt/dust,
/turf/open/floor/plating/snowed/smoothed,
/area/icemoon)
"DG" = (
/obj/effect/decal/remains/human,
/turf/open/floor/carpet/red,
/area/icemoon)
"DM" = (
/obj/effect/decal/cleanable/dirt/dust,
/obj/effect/decal/cleanable/dirt/dust,
/obj/effect/turf_decal/snow,
/obj/item/candle/tribal_torch,
/turf/open/floor/wood,
/area/icemoon)
"DX" = (
/turf/open/floor/wood,
/area/icemoon)
"Es" = (
/obj/item/candle/tribal_torch,
/obj/effect/decal/cleanable/dirt/dust,
/obj/effect/turf_decal/snow,
/turf/open/floor/plasteel,
/area/icemoon)
"Ez" = (
/obj/structure/chair/pew/left{
	dir = 1
	},
/obj/effect/decal/cleanable/dirt/dust,
/turf/open/floor/plasteel/dark/snowdin,
/area/icemoon)
"ES" = (
/obj/item/candle/tribal_torch,
/obj/effect/decal/cleanable/dirt/dust,
/obj/effect/turf_decal/snow,
/obj/effect/decal/cleanable/dirt/dust,
/turf/open/floor/plasteel,
/area/icemoon)
"EV" = (
/obj/structure/closet/cabinet,
/obj/item/clothing/head/helmet/chaplain/witchunter_hat,
/obj/item/clothing/suit/armor/riot/chaplain/witchhunter,
/obj/item/nullrod/scythe/talking/chainsword,
/obj/effect/decal/cleanable/dirt/dust,
/turf/open/floor/carpet/red,
/area/icemoon)
"Fu" = (
/mob/living/simple_animal/hostile/guardian/gravitokinetic,
/obj/effect/decal/cleanable/dirt/dust,
/obj/effect/decal/cleanable/dirt/dust,
/turf/open/floor/carpet/red,
/area/icemoon)
"GY" = (
/obj/effect/decal/cleanable/dirt/dust,
/turf/open/floor/plasteel/dark/snowdin,
/area/icemoon)
"IJ" = (
/obj/structure/railing{
	dir = 8
	},
/obj/effect/turf_decal/corner/black/half{
	dir = 8
	},
/obj/item/candle/tribal_torch,
/turf/open/floor/plasteel,
/area/icemoon)
"IT" = (
/obj/effect/decal/cleanable/dirt/dust,
/obj/effect/decal/remains/human,
/turf/open/floor/carpet/red,
/area/icemoon)
"Js" = (
/obj/effect/decal/cleanable/dirt/dust,
/turf/open/floor/plating/snowed,
/area/icemoon)
"Kh" = (
/obj/structure/chair/pew{
	dir = 1
	},
/obj/effect/decal/remains/human,
/turf/open/floor/plating/snowed,
/area/icemoon)
"KN" = (
/obj/structure/chair/pew{
	dir = 1
	},
/obj/effect/decal/cleanable/dirt/dust,
/turf/open/floor/plasteel,
/area/icemoon)
"KR" = (
/obj/effect/decal/cleanable/dirt/dust,
/obj/effect/decal/cleanable/dirt/dust,
/obj/effect/decal/cleanable/dirt/dust,
/obj/effect/decal/cleanable/dirt/dust,
/turf/open/floor/carpet/red,
/area/icemoon)
"Li" = (
/obj/structure/chair/pew{
	dir = 1
	},
/obj/effect/decal/cleanable/dirt/dust,
/obj/effect/turf_decal/snow,
/turf/open/floor/plating/snowed/smoothed,
/area/icemoon)
"Ly" = (
/obj/structure/mineral_door/wood,
/obj/structure/barricade/wooden/snowed,
/turf/open/floor/wood,
/area/icemoon)
"LK" = (
/obj/structure/railing{
	dir = 4
	},
/obj/effect/turf_decal/corner/black/half{
	dir = 4
	},
/obj/effect/decal/cleanable/dirt/dust,
/turf/open/floor/plasteel,
/area/icemoon)
"LV" = (
/obj/structure/chair/pew{
	dir = 1
	},
/obj/effect/decal/cleanable/dirt/dust,
/obj/effect/decal/cleanable/dirt/dust,
/turf/open/floor/plating/snowed,
/area/icemoon)
"Mw" = (
/obj/effect/turf_decal/snow,
/obj/effect/decal/cleanable/dirt/dust,
/turf/open/floor/plating/snowed,
/area/icemoon)
"MR" = (
/obj/effect/decal/cleanable/dirt/dust,
/mob/living/simple_animal/hostile/guardian/gravitokinetic,
/turf/open/floor/carpet/red,
/area/icemoon)
"MX" = (
/obj/structure/table/wood,
/obj/item/candle/infinite,
/turf/open/floor/wood,
/area/icemoon)
"Nb" = (
/obj/effect/decal/cleanable/dirt/dust,
/obj/effect/decal/cleanable/dirt/dust,
/turf/open/floor/plating/snowed,
/area/icemoon)
"Ns" = (
/obj/effect/decal/cleanable/dirt/dust,
/mob/living/simple_animal/hostile/guardian/punch,
/obj/item/candle/tribal_torch,
/turf/open/floor/wood,
/area/icemoon)
"ND" = (
/obj/structure/chair/pew/right{
	dir = 1
	},
/obj/effect/turf_decal/snow,
/turf/open/floor/plasteel,
/area/icemoon)
"NV" = (
/obj/item/candle/tribal_torch,
/obj/effect/decal/cleanable/dirt/dust,
/obj/effect/decal/cleanable/dirt/dust,
/obj/effect/decal/cleanable/dirt/dust,
/turf/open/floor/plating/snowed/smoothed,
/area/icemoon)
"NX" = (
/obj/structure/chair/pew/right{
	dir = 1
	},
/turf/open/floor/plasteel,
/area/icemoon)
"Ox" = (
/obj/structure/railing{
	dir = 6
	},
/obj/effect/turf_decal/corner/black/three_quarters,
/turf/open/floor/plasteel,
/area/icemoon)
"Oy" = (
/obj/structure/closet/cabinet,
/obj/item/storage/book/bible,
/obj/item/clothing/suit/hooded/chaplain_hoodie,
/obj/effect/decal/cleanable/dirt/dust,
/obj/effect/decal/cleanable/dirt/dust,
/obj/item/reagent_containers/food/drinks/bottle/holywater,
/turf/open/floor/carpet/black,
/area/icemoon)
"OC" = (
/obj/effect/decal/cleanable/dirt/dust,
/obj/effect/decal/cleanable/dirt/dust,
/turf/open/floor/plasteel/dark/snowdin,
/area/icemoon)
"PQ" = (
/obj/effect/decal/cleanable/dirt/dust,
/turf/open/floor/carpet/black,
/area/icemoon)
"PZ" = (
/obj/effect/decal/cleanable/dirt/dust,
/obj/effect/decal/cleanable/dirt/dust{
	pixel_y = 8
	},
/obj/effect/decal/cleanable/dirt/dust,
/obj/effect/decal/cleanable/dirt/dust,
/turf/open/floor/carpet/red,
/area/icemoon)
"QC" = (
/obj/structure/chair/pew/left{
	dir = 1
	},
/turf/open/floor/plasteel,
/area/icemoon)
"Rf" = (
/mob/living/simple_animal/hostile/guardian/ranged,
/obj/effect/decal/cleanable/dirt/dust,
/turf/open/floor/plating/snowed,
/area/icemoon)
"Ro" = (
/obj/effect/decal/cleanable/dirt/dust,
/turf/open/floor/wood,
/area/icemoon)
"Rx" = (
/obj/item/candle/tribal_torch,
/obj/effect/turf_decal/snow,
/turf/open/floor/plasteel,
/area/icemoon)
"SP" = (
/obj/structure/chair/pew/right{
	dir = 1
	},
/obj/effect/turf_decal/snow,
/obj/effect/decal/cleanable/dirt/dust,
/turf/open/floor/plasteel,
/area/icemoon)
"Tb" = (
/obj/structure/chair/pew/left{
	dir = 1
	},
/obj/effect/decal/cleanable/dirt/dust,
/turf/open/floor/plating/snowed,
/area/icemoon)
"Uf" = (
/obj/item/candle/tribal_torch,
/turf/open/floor/plating/snowed/smoothed,
/area/icemoon)
"Ui" = (
/obj/structure/railing{
	dir = 4
	},
/obj/effect/turf_decal/corner/black/half{
	dir = 4
	},
/obj/item/candle/tribal_torch,
/obj/effect/decal/cleanable/dirt/dust,
/turf/open/floor/plasteel,
/area/icemoon)
"Us" = (
/turf/open/floor/plasteel,
/area/icemoon)
"Uw" = (
/obj/effect/decal/cleanable/dirt/dust,
/obj/effect/decal/cleanable/dirt/dust,
/turf/open/floor/wood,
/area/icemoon)
"UO" = (
/obj/structure/closet/cabinet,
/obj/item/clothing/gloves/plate/blue,
/obj/item/clothing/head/helmet/plate/crusader/blue,
/obj/item/clothing/suit/armor/plate/crusader/blue,
/obj/item/reagent_containers/food/drinks/bottle/holywater,
/obj/item/nullrod,
/obj/effect/decal/cleanable/dirt/dust,
/turf/open/floor/carpet/red,
/area/icemoon)
"Vo" = (
/turf/open/floor/plating/snowed,
/area/icemoon)
"WO" = (
/obj/structure/chair/pew{
	dir = 1
	},
/obj/effect/decal/cleanable/dirt/dust,
/obj/effect/decal/cleanable/dirt/dust,
/turf/open/floor/plasteel/dark/snowdin,
/area/icemoon)
"Xl" = (
/turf/open/floor/plasteel/stairs{
	dir = 1
	},
/area/icemoon)
"XL" = (
/obj/effect/decal/remains/human,
/turf/closed/wall/mineral/iron,
/area/icemoon)
"Yl" = (
/turf/open/floor/plating/snowed/smoothed,
/area/icemoon)
"Zq" = (
/obj/item/candle/tribal_torch,
/obj/effect/decal/cleanable/dirt/dust,
/obj/effect/decal/cleanable/dirt/dust,
/turf/open/floor/plating/snowed,
/area/icemoon)
"Zv" = (
/obj/effect/decal/cleanable/dirt/dust,
/obj/effect/decal/cleanable/dirt/dust,
/obj/effect/decal/cleanable/dirt/dust,
/turf/open/floor/wood,
/area/icemoon)
"ZP" = (
/obj/structure/railing,
/obj/effect/turf_decal/corner/black/half,
/obj/effect/decal/cleanable/dirt/dust,
/obj/item/clothing/under/costume/kilt/highlander,
/obj/item/clothing/head/beret/highlander,
/turf/open/floor/plasteel,
/area/icemoon)
"ZZ" = (
/obj/structure/chair/pew/right{
	dir = 1
	},
/obj/effect/decal/cleanable/dirt/dust,
/obj/effect/decal/remains/human,
/obj/effect/turf_decal/snow,
/obj/effect/turf_decal/snow,
/turf/open/floor/plasteel,
/area/icemoon)

(1,1,1) = {"
pK
pK
pK
pK
uZ
uZ
uZ
pK
pK
pK
pK
pK
pK
pK
pK
pK
pK
pK
pK
pK
pK
pK
pK
pK
uZ
uZ
uZ
uZ
pK
pK
XL
pK
"}
(2,1,1) = {"
pK
xB
fW
tm
Oy
BB
pK
Dh
ic
so
zP
Us
Us
vq
ic
ic
yt
jj
jA
kq
Yl
hU
Vo
Tb
GY
Ez
iG
Di
OC
hU
qx
pK
"}
(3,1,1) = {"
pK
fW
fW
bf
yU
cg
uZ
cU
Bf
Dh
qg
Dh
Ui
nL
Dh
ic
Js
Bn
Yl
ed
uq
LV
pL
ed
Js
jM
jA
KN
pp
WO
pp
tm
"}
(4,1,1) = {"
pK
fW
fW
uZ
uZ
uZ
tm
lW
Dh
Dh
zP
Dh
rI
Xl
DG
sc
Zq
NX
cQ
rr
wl
wT
Rx
ZZ
nF
SP
ES
ob
Es
nd
gV
tm
"}
(5,1,1) = {"
pK
oT
fW
pK
tB
yU
tm
ic
Bf
so
zP
Dh
pH
wV
Dh
Bf
ic
lL
Dh
Dh
pf
DG
Dh
Dh
Bf
ic
Dh
Dh
Dh
pc
Dh
tm
"}
(6,1,1) = {"
pK
oT
fW
bf
yU
bb
uZ
UO
Bf
Bf
wP
IT
qr
ZP
Bf
MR
CH
KR
Dh
IT
Bf
Dh
Bf
Dh
Dh
wJ
Bf
lL
Dh
Bf
Dh
uD
"}
(7,1,1) = {"
pK
fW
fW
uZ
uZ
pK
uZ
Dh
Bf
Fu
aF
Dh
LK
Ox
Dh
IT
Dh
ic
lL
PZ
lL
Dh
Dh
Bf
Dh
lL
Dh
ic
Dh
Bf
Dh
uZ
"}
(8,1,1) = {"
pK
DM
fW
tm
Oy
PQ
uZ
lW
Dh
Bf
aF
ic
Xl
Xl
Dh
kn
Es
gh
Es
oI
cQ
tu
Uf
QC
Zq
kq
NV
Ez
qb
hU
Rx
uZ
"}
(9,1,1) = {"
pK
Uw
Uw
id
yU
cg
tm
EV
Dh
ic
aF
Dh
IJ
wV
Bf
Dh
iG
Li
Vo
Bn
in
qe
px
Kh
Vo
qe
Mw
eR
mY
Bn
Vo
pK
"}
(10,1,1) = {"
pK
Uw
oT
tm
uZ
pK
pK
Bf
Dh
jt
wP
Us
Us
gH
Dh
Dh
Rf
de
zT
rM
iG
aN
iG
wT
Nb
NX
Yl
ND
Vo
nd
Vo
pK
"}
(11,1,1) = {"
pK
Uw
fW
uZ
ve
PQ
pK
Zv
uZ
uZ
uZ
pK
pK
pK
pK
pK
pK
pK
pK
pK
pK
pK
pK
pK
pK
pK
pK
pK
pK
pK
pK
pK
"}
(12,1,1) = {"
pK
oT
DX
bf
PQ
bb
uZ
Uw
tm
me
fW
MX
DX
pK
yX
yX
yX
yX
yX
yX
yX
yX
yX
yX
yX
yX
yX
yX
yX
yX
yX
yX
"}
(13,1,1) = {"
pK
fW
Uw
uZ
pK
uZ
tm
Uw
uZ
sj
yU
gy
lz
pK
yX
yX
yX
yX
yX
yX
yX
yX
yX
yX
yX
yX
yX
yX
yX
yX
yX
yX
"}
(14,1,1) = {"
pK
DX
Uw
fW
fW
fW
fW
Uw
pK
AJ
yU
rf
qz
pK
yX
yX
yX
yX
yX
yX
yX
yX
yX
yX
yX
yX
yX
yX
yX
yX
yX
yX
"}
(15,1,1) = {"
pK
Ns
Ro
Uw
fW
fW
ha
Uw
Ly
fW
Ro
fD
qz
pK
yX
yX
yX
yX
yX
yX
yX
yX
yX
yX
yX
yX
yX
yX
yX
yX
yX
yX
"}
(16,1,1) = {"
pK
pK
pK
pK
pK
pK
pK
pK
pK
uZ
pK
pK
pK
pK
yX
yX
yX
yX
yX
yX
yX
yX
yX
yX
yX
yX
yX
yX
yX
yX
yX
yX
"}
