//MAP CONVERTED BY dmm2tgm.py THIS HEADER COMMENT PREVENTS RECONVERSION, DO NOT REMOVE
"am" = (
/obj/machinery/door/airlock/maintenance/external,
/turf/open/floor/carpet/red_gold,
/area/space)
"bv" = (
/turf/open/floor/mineral/plastitanium,
/area/space)
"cl" = (
/turf/open/floor/carpet/red_gold,
/area/space)
"eU" = (
/turf/open/floor/circuit/red/anim,
/area/space)
"fa" = (
/turf/open/floor/mineral/plastitanium/red,
/area/space)
"fF" = (
/obj/structure/lattice/catwalk,
/turf/open/floor/plasteel/patterned/grid,
/area/space)
"fR" = (
/obj/machinery/power/terminal{
	dir = 8
	},
/turf/open/floor/plating,
/area/space)
"iv" = (
/turf/open/floor/carpet/purple,
/area/space)
"iC" = (
/obj/effect/turf_decal/syndicateemblem/middle/left,
/turf/open/floor/circuit/red/anim,
/area/space)
"je" = (
/obj/machinery/door/firedoor/heavy,
/obj/machinery/door/airlock/science/glass,
/turf/open/floor/mineral/titanium/tiled/purple,
/area/space)
"jL" = (
/obj/machinery/computer/helm{
	dir = 8
	},
/turf/open/floor/circuit/red/off,
/area/space)
"jQ" = (
/turf/open/floor/plasteel/patterned/grid,
/area/space)
"kJ" = (
/obj/item/kirbyplants/random,
/turf/open/floor/mineral/plastitanium,
/area/space)
"lc" = (
/turf/open/floor/plastic,
/area/space)
"mH" = (
/obj/machinery/door/airlock/maintenance/external,
/turf/open/floor/plasteel/patterned/grid,
/area/space)
"nm" = (
/obj/machinery/door/firedoor/heavy,
/turf/open/floor/carpet/purple,
/area/space)
"no" = (
/obj/machinery/door/firedoor/heavy,
/obj/machinery/door/airlock/engineering/glass,
/turf/open/floor/plasteel/patterned/grid,
/area/space)
"ns" = (
/obj/effect/turf_decal/syndicateemblem/top/right,
/turf/open/floor/circuit/red/anim,
/area/space)
"oq" = (
/obj/machinery/door/firedoor/heavy,
/obj/machinery/door/airlock/medical/glass,
/turf/open/floor/mineral/titanium/tiled/blue,
/area/space)
"pY" = (
/obj/machinery/door/airlock/maintenance/external,
/obj/machinery/door/firedoor/heavy,
/turf/open/floor/plating,
/area/space)
"qz" = (
/obj/machinery/door/firedoor/heavy,
/turf/open/floor/mineral/titanium/tiled,
/area/space)
"qN" = (
/turf/open/floor/carpet/donk,
/area/space)
"qU" = (
/obj/effect/spawner/structure/window/plasma/reinforced/plastitanium,
/obj/effect/spawner/structure/window/plasma/reinforced/plastitanium,
/turf/open/floor/plating,
/area/space)
"qZ" = (
/obj/machinery/door/firedoor/heavy,
/obj/machinery/door/airlock/engineering/glass,
/turf/open/floor/mineral/titanium/tiled,
/area/space)
"sf" = (
/obj/effect/spawner/structure/window/plasma/reinforced/plastitanium,
/turf/open/floor/plating,
/area/space)
"sR" = (
/obj/structure/fans/tiny,
/turf/open/floor/plasteel/patterned/grid,
/area/space)
"sY" = (
/obj/effect/turf_decal/syndicateemblem/middle/middle,
/turf/open/floor/circuit/red/anim,
/area/space)
"tm" = (
/obj/machinery/door/firedoor/heavy,
/turf/open/floor/plating,
/area/space)
"tp" = (
/turf/open/floor/mineral/titanium/tiled,
/area/space)
"vp" = (
/obj/effect/turf_decal/syndicateemblem/top/left,
/turf/open/floor/circuit/red/anim,
/area/space)
"vz" = (
/turf/open/floor/plasteel/vaporwave,
/area/space)
"vV" = (
/obj/machinery/door/airlock/engineering/glass,
/obj/machinery/door/firedoor/heavy,
/turf/open/floor/plasteel/patterned/grid,
/area/space)
"wd" = (
/obj/machinery/door/airlock/maintenance/external,
/turf/open/floor/plasteel/vaporwave,
/area/space)
"yL" = (
/obj/effect/turf_decal/syndicateemblem/bottom/left,
/turf/open/floor/circuit/red/anim,
/area/space)
"zg" = (
/obj/effect/turf_decal/syndicateemblem/top/middle,
/turf/open/floor/circuit/red/anim,
/area/space)
"zv" = (
/obj/item/kirbyplants/random,
/turf/open/floor/mineral/titanium/tiled/white,
/area/space)
"zF" = (
/obj/structure/shuttle/engine/large{
	dir = 8
	},
/turf/open/space/basic,
/area/space)
"Bk" = (
/turf/open/floor/plating,
/area/space)
"CD" = (
/turf/open/floor/wood,
/area/space)
"Dd" = (
/obj/machinery/power/shuttle/engine/electric{
	dir = 4
	},
/turf/open/space/basic,
/area/space)
"ES" = (
/turf/open/floor/mineral/titanium/tiled/blue,
/area/space)
"EU" = (
/obj/machinery/door/airlock/engineering,
/turf/open/floor/plasteel/patterned/grid,
/area/space)
"Fg" = (
/turf/closed/wall/mineral/plastitanium/interior,
/area/space)
"FE" = (
/obj/machinery/door/airlock/engineering,
/obj/machinery/door/firedoor/heavy,
/turf/open/floor/plasteel/patterned/grid,
/area/space)
"Gl" = (
/turf/open/floor/mineral/titanium/tiled/white,
/area/space)
"Jf" = (
/obj/item/kirbyplants/random,
/turf/open/floor/mineral/plastitanium/red,
/area/space)
"Ke" = (
/obj/machinery/door/firedoor/heavy,
/obj/machinery/door/airlock/engineering,
/turf/open/floor/plasteel/patterned/grid,
/area/space)
"Ko" = (
/turf/open/floor/mineral/titanium/tiled/purple,
/area/space)
"Ks" = (
/obj/machinery/door/firedoor/heavy,
/obj/machinery/door/airlock/hatch,
/turf/open/floor/mineral/plastitanium,
/area/space)
"KK" = (
/turf/open/space/basic,
/area/space)
"Li" = (
/obj/machinery/door/firedoor/heavy,
/turf/open/floor/carpet/donk,
/area/space)
"LL" = (
/obj/machinery/door/airlock/maintenance/external,
/turf/open/floor/plating,
/area/space)
"OG" = (
/turf/open/floor/circuit/red/off,
/area/space)
"OO" = (
/obj/effect/spawner/lootdrop/grille_or_trash,
/turf/open/floor/plating,
/area/space)
"PZ" = (
/obj/effect/turf_decal/syndicateemblem/bottom/middle,
/turf/open/floor/circuit/red/anim,
/area/space)
"QY" = (
/obj/machinery/door/firedoor/heavy,
/turf/open/floor/wood,
/area/space)
"Rm" = (
/obj/machinery/door/firedoor/heavy,
/obj/machinery/door/airlock/hatch,
/turf/open/floor/circuit/red/off,
/area/space)
"Sf" = (
/obj/effect/turf_decal/syndicateemblem/bottom/right,
/turf/open/floor/circuit/red/anim,
/area/space)
"US" = (
/obj/machinery/door/firedoor/heavy,
/turf/open/floor/mineral/plastitanium,
/area/space)
"Vm" = (
/obj/machinery/power/smes/shuttle/precharged{
	dir = 4
	},
/obj/structure/window/plasma/reinforced/spawner{
	dir = 8
	},
/turf/open/floor/plating,
/area/space)
"VC" = (
/obj/machinery/door/firedoor/heavy,
/turf/open/floor/plastic,
/area/space)
"Zh" = (
/obj/effect/turf_decal/syndicateemblem/middle/right,
/turf/open/floor/circuit/red/anim,
/area/space)

(1,1,1) = {"
KK
KK
KK
KK
KK
KK
KK
KK
KK
KK
zF
KK
KK
KK
zF
KK
KK
KK
KK
KK
KK
KK
KK
KK
KK
KK
KK
zF
KK
KK
KK
zF
KK
KK
KK
KK
KK
KK
KK
KK
"}
(2,1,1) = {"
KK
KK
KK
KK
KK
KK
KK
KK
KK
KK
KK
KK
KK
KK
KK
KK
KK
Dd
KK
KK
Dd
KK
KK
Dd
KK
KK
KK
KK
KK
KK
KK
KK
KK
KK
KK
KK
KK
KK
KK
KK
"}
(3,1,1) = {"
KK
KK
KK
KK
KK
Dd
KK
KK
Fg
Fg
Fg
Fg
Fg
Fg
Fg
Fg
Fg
Vm
Fg
Fg
Vm
Fg
Fg
Vm
Fg
Fg
Fg
Fg
Fg
Fg
Fg
Fg
KK
KK
KK
Dd
KK
KK
zF
KK
"}
(4,1,1) = {"
KK
KK
zF
KK
Fg
Vm
Fg
Fg
Fg
Bk
Bk
Bk
Bk
Bk
Bk
Bk
Bk
fR
Bk
Bk
fR
Bk
Bk
fR
Bk
Bk
Bk
Bk
Bk
Bk
Bk
Fg
Fg
Fg
Fg
Vm
Fg
KK
KK
KK
"}
(5,1,1) = {"
KK
KK
KK
Fg
Fg
fR
Bk
Bk
Bk
Bk
fF
fF
fF
fF
fF
fF
fF
fF
fF
fF
fF
fF
fF
fF
fF
fF
fF
fF
fF
fF
Bk
Bk
Bk
Bk
Bk
fR
Fg
Fg
Fg
KK
"}
(6,1,1) = {"
KK
Fg
Fg
Fg
Bk
Bk
fF
fF
fF
fF
jQ
jQ
jQ
jQ
jQ
jQ
jQ
jQ
jQ
jQ
jQ
jQ
jQ
jQ
jQ
jQ
jQ
jQ
jQ
jQ
fF
fF
fF
fF
fF
Bk
Bk
Fg
Fg
KK
"}
(7,1,1) = {"
KK
Fg
Fg
Bk
Bk
fF
jQ
jQ
jQ
jQ
jQ
jQ
jQ
jQ
jQ
jQ
jQ
jQ
jQ
jQ
jQ
jQ
jQ
jQ
jQ
jQ
jQ
jQ
jQ
jQ
jQ
jQ
jQ
jQ
jQ
fF
Bk
Bk
Fg
KK
"}
(8,1,1) = {"
KK
Fg
Bk
Bk
fF
jQ
jQ
jQ
Fg
Fg
Fg
Fg
Fg
Fg
Fg
EU
Fg
Fg
Fg
pY
Fg
Fg
Fg
Fg
Fg
Fg
Fg
Fg
Fg
pY
Fg
Fg
Fg
Fg
Fg
jQ
fF
Bk
Fg
KK
"}
(9,1,1) = {"
KK
Fg
fF
fF
jQ
jQ
jQ
jQ
FE
jQ
jQ
Fg
Bk
LL
jQ
jQ
jQ
LL
Bk
Bk
Bk
Bk
Bk
OO
Bk
Bk
Bk
Fg
Bk
Bk
Bk
Fg
bv
bv
Fg
Fg
Fg
Fg
Fg
Fg
"}
(10,1,1) = {"
KK
Fg
jQ
jQ
jQ
jQ
jQ
jQ
Fg
jQ
jQ
Fg
Bk
Fg
jQ
jQ
jQ
Fg
Fg
LL
Fg
Fg
Fg
Fg
Fg
LL
Fg
Fg
OO
Bk
Bk
pY
bv
bv
Fg
tp
tp
tp
tp
sR
"}
(11,1,1) = {"
KK
Fg
jQ
jQ
jQ
jQ
jQ
jQ
Fg
jQ
jQ
Fg
Bk
Fg
jQ
jQ
jQ
Fg
jQ
jQ
jQ
jQ
jQ
Fg
jQ
jQ
jQ
Fg
Bk
Bk
Bk
Fg
bv
bv
sf
tp
bv
bv
bv
sR
"}
(12,1,1) = {"
KK
Fg
jQ
jQ
jQ
Fg
Fg
Fg
Fg
Ke
Fg
Fg
OO
Fg
Fg
EU
Fg
Fg
jQ
jQ
jQ
jQ
jQ
mH
jQ
jQ
jQ
mH
Bk
Bk
OO
Fg
bv
bv
sf
tp
bv
bv
bv
sR
"}
(13,1,1) = {"
KK
Fg
Fg
Fg
Fg
Fg
OO
LL
bv
bv
bv
pY
Bk
Fg
bv
bv
bv
Fg
jQ
jQ
jQ
jQ
jQ
Fg
jQ
jQ
jQ
Fg
OO
Bk
Bk
Fg
bv
bv
Fg
tp
bv
bv
bv
sR
"}
(14,1,1) = {"
KK
Fg
OO
Bk
Bk
Bk
Bk
Fg
bv
bv
bv
Fg
Fg
Fg
US
US
US
Fg
Fg
Fg
no
Fg
Fg
Fg
Fg
no
Fg
Fg
Fg
Fg
Fg
Fg
US
US
Fg
tp
bv
bv
bv
sR
"}
(15,1,1) = {"
KK
Fg
Bk
Fg
Fg
Fg
Fg
Fg
bv
bv
bv
US
bv
bv
bv
bv
bv
US
bv
bv
bv
bv
bv
bv
bv
bv
bv
bv
bv
bv
US
bv
bv
bv
sf
tp
bv
bv
bv
sR
"}
(16,1,1) = {"
KK
Fg
Bk
Fg
iv
iv
iv
Fg
bv
bv
bv
US
bv
bv
bv
bv
bv
US
bv
bv
bv
bv
bv
bv
bv
bv
bv
bv
bv
bv
US
bv
bv
bv
tm
tp
bv
bv
bv
sR
"}
(17,1,1) = {"
KK
Fg
Bk
Fg
iv
iv
iv
nm
bv
bv
bv
US
bv
bv
bv
bv
bv
US
bv
bv
bv
bv
bv
bv
bv
bv
bv
bv
bv
bv
US
bv
bv
bv
sf
tp
bv
bv
bv
sR
"}
(18,1,1) = {"
KK
Fg
Bk
Bk
iv
iv
iv
Fg
bv
bv
bv
Fg
Fg
Fg
sf
sf
sf
Fg
Fg
Fg
bv
bv
bv
Gl
Gl
zv
Fg
Fg
Fg
Fg
Fg
US
US
US
Fg
tp
bv
bv
bv
sR
"}
(19,1,1) = {"
KK
Fg
Bk
Fg
iv
iv
iv
Fg
bv
bv
bv
Fg
Bk
Fg
lc
lc
lc
lc
lc
VC
bv
bv
bv
Gl
Gl
Gl
Fg
tp
tp
tp
sf
bv
bv
bv
Fg
tp
tp
tp
tp
sR
"}
(20,1,1) = {"
KK
Fg
OO
Fg
iv
iv
iv
sf
bv
bv
bv
Fg
Bk
Fg
lc
lc
lc
lc
lc
Fg
bv
bv
bv
Gl
Gl
Gl
Fg
tp
tp
tp
sf
bv
bv
bv
Fg
sf
sf
qz
qz
Fg
"}
(21,1,1) = {"
KK
Fg
Bk
Fg
iv
iv
iv
sf
bv
bv
bv
Fg
Bk
Fg
lc
lc
lc
lc
lc
sf
bv
bv
bv
Gl
Gl
Gl
Fg
tp
tp
tp
sf
bv
bv
bv
sf
tp
tp
tp
tp
Fg
"}
(22,1,1) = {"
KK
Fg
Bk
Fg
iv
iv
iv
sf
bv
bv
bv
Fg
Bk
Fg
lc
lc
lc
lc
lc
sf
bv
bv
bv
Gl
Gl
Gl
Fg
tp
tp
tp
Fg
bv
bv
bv
sf
tp
bv
bv
bv
Fg
"}
(23,1,1) = {"
KK
Fg
Bk
Fg
LL
Fg
Fg
Fg
bv
bv
bv
Fg
Bk
Fg
Fg
lc
lc
lc
lc
sf
bv
bv
bv
Gl
Gl
Gl
Fg
tp
tp
tp
qZ
bv
bv
bv
Fg
tp
bv
bv
bv
sf
"}
(24,1,1) = {"
KK
Fg
Bk
Bk
Bk
Bk
OO
LL
bv
bv
bv
Fg
Bk
Bk
LL
lc
lc
lc
lc
sf
bv
bv
bv
Gl
Gl
Gl
Fg
tp
tp
tp
Fg
bv
bv
bv
sf
tp
bv
bv
bv
sf
"}
(25,1,1) = {"
KK
Fg
Bk
Fg
LL
Fg
Fg
Fg
US
US
US
Fg
Fg
Bk
Fg
Fg
Fg
Fg
Fg
Fg
bv
bv
bv
Gl
Gl
Gl
Fg
tp
tp
tp
sf
bv
bv
bv
US
tp
bv
bv
bv
sf
"}
(26,1,1) = {"
KK
Fg
Bk
Fg
jQ
jQ
jQ
Fg
bv
bv
bv
LL
Bk
Bk
Bk
LL
CD
CD
CD
Fg
bv
bv
bv
Gl
Gl
Gl
Fg
tp
tp
tp
sf
bv
bv
bv
sf
tp
bv
bv
bv
sf
"}
(27,1,1) = {"
KK
Fg
Bk
Fg
jQ
jQ
jQ
Fg
kJ
bv
bv
Fg
Bk
Fg
Fg
Fg
CD
CD
CD
Fg
bv
bv
bv
Gl
Gl
Gl
Fg
tp
tp
tp
sf
bv
bv
bv
Fg
tp
bv
bv
bv
sf
"}
(28,1,1) = {"
KK
Fg
Bk
Fg
jQ
jQ
jQ
vV
bv
bv
bv
Fg
Bk
Fg
CD
CD
CD
CD
CD
QY
bv
bv
bv
Fg
Fg
Fg
Fg
Fg
Fg
LL
Fg
US
US
US
Fg
tp
tp
tp
tp
Fg
"}
(29,1,1) = {"
KK
Fg
Bk
Fg
jQ
jQ
jQ
Fg
kJ
bv
bv
Fg
Bk
Fg
CD
CD
CD
CD
CD
Fg
bv
bv
bv
LL
Bk
Bk
Bk
OO
Bk
Bk
LL
bv
bv
bv
Fg
Fg
Fg
Fg
Fg
Fg
"}
(30,1,1) = {"
Fg
Fg
Bk
Fg
jQ
jQ
jQ
sf
bv
bv
bv
Fg
Bk
Fg
CD
CD
CD
CD
CD
Fg
US
US
US
Fg
Bk
Fg
Fg
Fg
Fg
Fg
Fg
bv
bv
bv
fa
fa
fa
Jf
Fg
KK
"}
(31,1,1) = {"
Fg
OO
Bk
Fg
jQ
jQ
jQ
sf
bv
bv
bv
Fg
Bk
Fg
CD
CD
CD
CD
CD
sf
bv
bv
bv
Fg
Bk
Fg
ES
ES
ES
ES
Fg
bv
bv
bv
fa
fa
fa
fa
sf
KK
"}
(32,1,1) = {"
Fg
Bk
Fg
Fg
LL
Fg
Fg
Fg
bv
bv
bv
Fg
Bk
Fg
CD
CD
CD
CD
CD
sf
bv
bv
bv
Fg
OO
Fg
ES
ES
ES
ES
sf
bv
bv
bv
fa
fa
fa
fa
sf
KK
"}
(33,1,1) = {"
Fg
Bk
Bk
Bk
Bk
Bk
OO
LL
bv
bv
bv
Fg
Bk
Fg
CD
CD
CD
CD
CD
sf
bv
bv
bv
Fg
Bk
Fg
ES
ES
ES
ES
sf
bv
bv
bv
fa
fa
fa
fa
Fg
KK
"}
(34,1,1) = {"
Fg
Bk
Fg
Bk
Fg
Fg
Fg
Fg
bv
bv
bv
Fg
Bk
Fg
CD
CD
CD
CD
CD
sf
bv
bv
bv
Fg
Bk
Fg
ES
ES
ES
ES
Fg
kJ
bv
bv
fa
fa
fa
fa
Fg
KK
"}
(35,1,1) = {"
Fg
Bk
Fg
Bk
Fg
qN
qN
Fg
bv
bv
bv
Fg
Bk
Fg
CD
CD
CD
CD
CD
Fg
bv
bv
bv
Fg
Bk
Fg
ES
ES
ES
ES
oq
bv
bv
bv
fa
fa
fa
fa
Fg
KK
"}
(36,1,1) = {"
Fg
Bk
Fg
OO
Fg
qN
qN
Fg
bv
bv
bv
Fg
Bk
Fg
Fg
LL
Fg
Fg
Fg
Fg
bv
bv
bv
Fg
Bk
Fg
ES
ES
ES
ES
Fg
kJ
bv
bv
fa
fa
fa
fa
Fg
KK
"}
(37,1,1) = {"
Fg
Fg
Fg
Bk
Fg
qN
qN
Fg
bv
bv
bv
LL
Bk
Bk
Bk
Bk
Bk
Bk
Bk
LL
bv
bv
bv
Fg
Bk
Fg
ES
ES
ES
ES
sf
bv
bv
bv
fa
fa
fa
fa
sf
KK
"}
(38,1,1) = {"
KK
Fg
Bk
Bk
Fg
qN
qN
Fg
bv
bv
bv
Fg
Fg
LL
Fg
Fg
Fg
Fg
Fg
Fg
bv
bv
bv
Fg
Bk
Fg
ES
ES
ES
ES
sf
bv
bv
bv
fa
fa
fa
fa
sf
KK
"}
(39,1,1) = {"
KK
Fg
Bk
Fg
Fg
qN
qN
Fg
bv
bv
bv
Fg
Ko
Ko
Ko
Ko
Ko
Ko
Ko
sf
bv
bv
bv
Fg
Bk
LL
ES
ES
ES
ES
sf
bv
bv
bv
fa
fa
fa
fa
sf
KK
"}
(40,1,1) = {"
KK
Fg
Bk
Fg
qN
qN
qN
Li
bv
bv
bv
Fg
Ko
Ko
Ko
Ko
Ko
Ko
Ko
je
bv
bv
bv
Fg
Bk
Fg
ES
ES
ES
ES
sf
bv
bv
bv
fa
fa
fa
fa
sf
KK
"}
(41,1,1) = {"
KK
Fg
Bk
LL
qN
qN
qN
Fg
bv
bv
bv
Fg
Ko
Ko
Ko
Ko
Ko
Ko
Ko
sf
bv
bv
bv
Fg
OO
Fg
ES
ES
ES
ES
sf
bv
bv
bv
fa
fa
fa
fa
Fg
KK
"}
(42,1,1) = {"
KK
Fg
Bk
Fg
qN
qN
qN
Fg
bv
bv
bv
Fg
Ko
Ko
Ko
Ko
Ko
Ko
Ko
Fg
bv
bv
bv
Fg
Bk
Fg
ES
ES
ES
ES
Fg
bv
bv
bv
fa
fa
fa
fa
Fg
KK
"}
(43,1,1) = {"
KK
Fg
OO
Fg
Fg
Fg
Fg
Fg
US
US
US
Fg
Fg
Fg
Fg
je
Fg
sf
sf
Fg
US
US
US
Fg
Fg
Fg
sf
sf
oq
Fg
Fg
bv
bv
bv
fa
fa
fa
fa
Fg
KK
"}
(44,1,1) = {"
KK
Fg
Bk
Bk
Bk
Bk
LL
bv
bv
bv
bv
bv
bv
bv
bv
bv
bv
bv
bv
US
bv
bv
bv
bv
bv
bv
bv
bv
bv
bv
US
bv
bv
bv
fa
fa
fa
fa
Fg
KK
"}
(45,1,1) = {"
KK
Fg
Fg
Fg
Fg
Bk
Fg
bv
bv
bv
bv
bv
bv
bv
bv
bv
bv
bv
bv
US
bv
bv
bv
bv
bv
bv
bv
bv
bv
bv
US
bv
bv
bv
fa
fa
fa
Fg
Fg
KK
"}
(46,1,1) = {"
KK
KK
KK
KK
Fg
Bk
Fg
bv
bv
bv
bv
bv
bv
bv
bv
bv
bv
bv
bv
US
bv
bv
bv
bv
bv
bv
bv
bv
bv
bv
US
bv
bv
bv
fa
fa
Fg
Fg
KK
KK
"}
(47,1,1) = {"
KK
KK
KK
KK
Fg
OO
Fg
Fg
Fg
Fg
Fg
sf
sf
sf
sf
Fg
Fg
Fg
Fg
Fg
bv
bv
bv
Fg
Fg
Fg
Fg
Fg
Fg
Fg
Fg
LL
Fg
Fg
Fg
Fg
Fg
KK
KK
KK
"}
(48,1,1) = {"
KK
KK
KK
KK
Fg
Bk
Bk
Bk
wd
vz
vz
vz
vz
vz
vz
vz
vz
vz
vz
sf
kJ
bv
kJ
Fg
cl
cl
cl
cl
cl
cl
Fg
Bk
Bk
Fg
KK
KK
KK
KK
KK
KK
"}
(49,1,1) = {"
KK
KK
KK
KK
Fg
Fg
Fg
Fg
Fg
vz
vz
vz
vz
vz
vz
vz
vz
vz
vz
Ks
bv
bv
bv
Ks
cl
cl
cl
cl
cl
Fg
Fg
OO
Bk
Fg
KK
KK
KK
KK
KK
KK
"}
(50,1,1) = {"
KK
KK
KK
KK
KK
KK
KK
KK
Fg
Fg
Fg
vz
vz
vz
vz
vz
vz
vz
vz
sf
kJ
bv
kJ
Fg
cl
cl
Fg
am
Fg
Fg
Bk
Bk
Bk
Fg
KK
KK
KK
KK
KK
KK
"}
(51,1,1) = {"
KK
KK
KK
KK
KK
KK
KK
KK
KK
KK
Fg
vz
vz
vz
vz
vz
vz
Fg
Fg
Fg
sf
Rm
sf
Fg
Fg
Fg
Fg
Bk
OO
Bk
Bk
Fg
Fg
Fg
KK
KK
KK
KK
KK
KK
"}
(52,1,1) = {"
KK
KK
KK
KK
KK
KK
KK
KK
KK
KK
Fg
Fg
Fg
Fg
Fg
vz
vz
Fg
vp
iC
yL
OG
vp
iC
yL
LL
Bk
Bk
Fg
Fg
Fg
Fg
KK
KK
KK
KK
KK
KK
KK
KK
"}
(53,1,1) = {"
KK
KK
KK
KK
KK
KK
KK
KK
KK
KK
KK
KK
KK
KK
Fg
Fg
Fg
Fg
zg
sY
PZ
OG
zg
sY
PZ
Fg
Fg
Fg
Fg
KK
KK
KK
KK
KK
KK
KK
KK
KK
KK
KK
"}
(54,1,1) = {"
KK
KK
KK
KK
KK
KK
KK
KK
KK
KK
KK
KK
KK
KK
KK
KK
sf
qU
ns
Zh
Sf
OG
ns
Zh
Sf
sf
sf
KK
KK
KK
KK
KK
KK
KK
KK
KK
KK
KK
KK
KK
"}
(55,1,1) = {"
KK
KK
KK
KK
KK
KK
KK
KK
KK
KK
KK
KK
KK
KK
KK
KK
KK
sf
sf
eU
eU
jL
eU
eU
sf
sf
KK
KK
KK
KK
KK
KK
KK
KK
KK
KK
KK
KK
KK
KK
"}
(56,1,1) = {"
KK
KK
KK
KK
KK
KK
KK
KK
KK
KK
KK
KK
KK
KK
KK
KK
KK
KK
sf
sf
sf
sf
sf
sf
sf
KK
KK
KK
KK
KK
KK
KK
KK
KK
KK
KK
KK
KK
KK
KK
"}
