//MAP CONVERTED BY dmm2tgm.py THIS HEADER COMMENT PREVENTS RECONVERSION, DO NOT REMOVE
"aG" = (
/obj/structure/cable{
	icon_state = "1-2"
	},
/obj/machinery/power/apc/auto_name/east,
/obj/structure/cable{
	icon_state = "0-2"
	},
/turf/open/floor/plating,
/area/ship/hallway/central)
"aX" = (
/obj/machinery/light/small,
/obj/machinery/camera/autoname{
	dir = 1
	},
/turf/open/floor/plating,
/area/ship/maintenance/aft)
"bM" = (
/turf/closed/wall/mineral/titanium/interior/blue,
/area/ship/storage)
"bQ" = (
/obj/effect/decal/cleanable/glass,
/turf/open/floor/plating,
/area/ship/storage)
"bU" = (
/obj/structure/closet/crate,
/obj/item/am_containment,
/obj/item/am_containment,
/obj/item/am_containment,
/obj/item/am_containment,
/obj/item/am_containment,
/obj/item/am_containment,
/obj/item/am_containment,
/obj/item/am_containment,
/turf/open/floor/plating,
/area/ship/bridge)
"cP" = (
/obj/effect/decal/cleanable/glass,
/turf/open/floor/plating,
/area/ship/maintenance/aft)
"cV" = (
/obj/structure/cable{
	icon_state = "4-8"
	},
/turf/open/floor/plating,
/area/ship/bridge)
"cZ" = (
/obj/effect/decal/cleanable/blood/footprints,
/turf/open/floor/plating,
/area/ship/hallway/central)
"de" = (
/obj/structure/cable{
	icon_state = "1-2"
	},
/turf/open/floor/plating,
/area/ship/hallway/central)
"df" = (
/obj/effect/decal/cleanable/glass,
/turf/open/floor/plating,
/area/ship/science/ai_chamber)
"dE" = (
/obj/machinery/mech_bay_recharge_port{
	dir = 8
	},
/obj/structure/window/reinforced/spawner{
	dir = 4
	},
/turf/open/floor/mineral/titanium/tiled/blue,
/area/ship/science/robotics)
"dW" = (
/obj/structure/rack,
/obj/item/mmi/posibrain,
/obj/item/mmi/posibrain,
/obj/item/mmi/posibrain,
/turf/open/floor/plating,
/area/ship/science/ai_chamber)
"er" = (
/obj/machinery/atmospherics/pipe/simple/orange/visible{
	dir = 4
	},
/obj/structure/cable{
	icon_state = "4-8"
	},
/obj/machinery/light/small,
/obj/machinery/camera/autoname{
	dir = 1
	},
/turf/open/floor/plating,
/area/ship/maintenance/aft)
"eF" = (
/obj/structure/table/reinforced,
/obj/machinery/power/apc/auto_name/north,
/obj/machinery/cell_charger,
/obj/structure/cable{
	icon_state = "0-8"
	},
/turf/open/floor/plating,
/area/ship/science/ai_chamber)
"eY" = (
/obj/machinery/atmospherics/pipe/simple/orange/visible{
	dir = 9
	},
/obj/structure/cable{
	icon_state = "1-8"
	},
/obj/structure/cable{
	icon_state = "1-2"
	},
/turf/open/floor/plating,
/area/ship/maintenance/aft)
"fe" = (
/obj/effect/turf_decal/box,
/obj/effect/decal/cleanable/glass,
/obj/effect/decal/cleanable/robot_debris/old,
/turf/open/floor/plasteel/patterned/cargo_one,
/area/ship/science/robotics)
"fI" = (
/obj/machinery/atmospherics/pipe/simple/orange/visible{
	dir = 4
	},
/obj/structure/cable{
	icon_state = "4-8"
	},
/obj/machinery/light/small{
	dir = 1
	},
/turf/open/floor/plating,
/area/ship/maintenance/aft)
"fP" = (
/obj/structure/cable{
	icon_state = "4-8"
	},
/turf/open/floor/plating,
/area/ship/storage)
"fQ" = (
/obj/machinery/button/door{
	id = "mech";
	name = "Mech Bay Blast Door Control";
	pixel_x = 5;
	pixel_y = 24
	},
/turf/open/space/basic,
/area/ship/science/robotics)
"gg" = (
/obj/machinery/light/small,
/turf/open/floor/plating,
/area/ship/crew/dorm)
"gw" = (
/obj/machinery/mech_bay_recharge_port{
	dir = 8
	},
/obj/structure/window/reinforced/spawner{
	dir = 4
	},
/obj/machinery/light{
	dir = 1
	},
/turf/open/floor/mineral/titanium/tiled/blue,
/area/ship/science/robotics)
"gz" = (
/turf/closed/wall/mineral/titanium/interior/blue,
/area/ship/bridge)
"hi" = (
/obj/machinery/power/smes/shuttle/precharged{
	dir = 4
	},
/obj/structure/window/reinforced/spawner/west,
/obj/machinery/door/window/eastleft,
/obj/structure/cable{
	icon_state = "0-8"
	},
/turf/open/floor/plating,
/area/ship/maintenance/aft)
"hC" = (
/obj/structure/cable{
	icon_state = "2-4"
	},
/obj/structure/cable{
	icon_state = "2-8"
	},
/turf/open/floor/plating,
/area/ship/hallway/central)
"hY" = (
/obj/structure/cable{
	icon_state = "1-8"
	},
/turf/open/floor/plating,
/area/ship/science/ai_chamber)
"if" = (
/obj/machinery/light/small{
	dir = 1
	},
/turf/open/floor/plating,
/area/ship/bridge)
"ig" = (
/obj/machinery/atmospherics/pipe/simple/orange/visible{
	dir = 10
	},
/obj/structure/cable{
	icon_state = "2-8"
	},
/turf/open/floor/plating,
/area/ship/maintenance/aft)
"ir" = (
/obj/structure/cable{
	icon_state = "1-4"
	},
/obj/item/radio/intercom{
	dir = 4;
	pixel_x = -22
	},
/turf/open/floor/plating,
/area/ship/bridge)
"jc" = (
/obj/machinery/camera/autoname{
	dir = 9
	},
/turf/open/space/basic,
/area/ship/maintenance/aft)
"ji" = (
/obj/structure/cable{
	icon_state = "1-2"
	},
/obj/structure/cable{
	icon_state = "2-4"
	},
/obj/structure/cable{
	icon_state = "4-8"
	},
/turf/open/floor/plating,
/area/ship/crew/dorm)
"jo" = (
/obj/structure/cable{
	icon_state = "1-2"
	},
/obj/machinery/light/small{
	dir = 4
	},
/turf/open/floor/plating,
/area/ship/hallway/central)
"kf" = (
/obj/effect/decal/cleanable/dirt/dust,
/turf/open/floor/plating,
/area/ship/science/ai_chamber)
"ki" = (
/obj/item/circuitboard/aicore,
/turf/open/floor/plating,
/area/ship/science/ai_chamber)
"ku" = (
/obj/machinery/camera/autoname{
	dir = 8
	},
/turf/open/floor/plating,
/area/ship/storage)
"kx" = (
/obj/structure/cable{
	icon_state = "4-8"
	},
/obj/effect/decal/cleanable/dirt/dust,
/turf/open/floor/plating,
/area/ship/bridge)
"lc" = (
/obj/structure/grille,
/obj/structure/window/shuttle{
	color = "#9ce9f6"
	},
/turf/open/floor/plating,
/area/ship/science/ai_chamber)
"lz" = (
/obj/structure/fluff/oldturret,
/turf/open/floor/plating,
/area/ship/science/ai_chamber)
"lD" = (
/obj/machinery/button/door{
	id = "mech";
	name = "Mech Bay Blast Door Control";
	pixel_x = 24;
	pixel_y = 24
	},
/turf/open/floor/mineral/titanium/tiled/blue,
/area/ship/science/robotics)
"mb" = (
/turf/open/floor/plating,
/area/ship/science/ai_chamber)
"mf" = (
/obj/machinery/camera/autoname{
	dir = 1
	},
/turf/open/space/basic,
/area/ship/science/ai_chamber)
"mt" = (
/obj/effect/decal/cleanable/glass,
/turf/open/floor/mineral/titanium/tiled/blue,
/area/ship/science/robotics)
"mA" = (
/obj/structure/cable{
	icon_state = "4-8"
	},
/obj/item/multitool,
/turf/open/floor/plating,
/area/ship/bridge)
"mE" = (
/obj/machinery/power/smes/engineering{
	dir = 8
	},
/obj/structure/cable,
/turf/open/floor/plating,
/area/ship/bridge)
"mI" = (
/obj/item/areaeditor/shuttle,
/turf/open/floor/plating,
/area/ship/bridge)
"nD" = (
/obj/effect/turf_decal/rechargefloor,
/obj/machinery/camera/autoname{
	dir = 1
	},
/turf/open/floor/plasteel/patterned/cargo_one,
/area/ship/science/robotics)
"nR" = (
/obj/machinery/power/terminal{
	dir = 8
	},
/obj/structure/cable{
	icon_state = "0-2"
	},
/obj/structure/cable{
	icon_state = "1-2"
	},
/turf/open/floor/plating,
/area/ship/maintenance/aft)
"oL" = (
/obj/structure/cable{
	icon_state = "1-2"
	},
/turf/open/floor/plating,
/area/ship/maintenance/aft)
"oN" = (
/obj/machinery/camera/autoname,
/turf/open/space/basic,
/area/ship/maintenance/aft)
"oT" = (
/obj/machinery/power/terminal{
	dir = 4
	},
/obj/structure/cable/yellow{
	icon_state = "0-2"
	},
/obj/effect/decal/cleanable/dirt/dust,
/turf/open/floor/plating,
/area/ship/bridge)
"oW" = (
/obj/machinery/mech_bay_recharge_port{
	dir = 8
	},
/obj/structure/window/reinforced/spawner{
	dir = 4
	},
/obj/machinery/light,
/turf/open/floor/mineral/titanium/tiled/blue,
/area/ship/science/robotics)
"pc" = (
/obj/effect/turf_decal/box,
/turf/open/floor/plasteel/patterned/cargo_one,
/area/ship/science/robotics)
"pu" = (
/obj/structure/grille/broken,
/obj/effect/decal/cleanable/glass,
/turf/open/floor/plating,
/area/ship/science/ai_chamber)
"pW" = (
/obj/machinery/door/airlock/solgov,
/turf/open/floor/plating,
/area/ship/hallway/central)
"qk" = (
/obj/item/reagent_containers/food/snacks/canned/beans{
	pixel_x = -5;
	pixel_y = 3
	},
/obj/item/reagent_containers/food/snacks/canned/beans{
	pixel_x = 2;
	pixel_y = 3
	},
/obj/item/reagent_containers/food/snacks/canned/beans{
	pixel_x = -2
	},
/obj/item/reagent_containers/food/drinks/waterbottle/large{
	pixel_x = 5
	},
/obj/item/reagent_containers/food/drinks/waterbottle/large{
	pixel_x = 1;
	pixel_y = -3
	},
/obj/item/reagent_containers/food/drinks/waterbottle/large{
	pixel_x = 8;
	pixel_y = -3
	},
/obj/structure/closet/crate{
	name = "human needs crate"
	},
/obj/item/storage/cans/sixbeer,
/obj/item/reagent_containers/food/snacks/rationpack,
/obj/item/reagent_containers/food/snacks/rationpack,
/obj/item/reagent_containers/food/snacks/rationpack,
/obj/item/reagent_containers/food/snacks/rationpack,
/obj/item/reagent_containers/food/snacks/rationpack,
/obj/item/reagent_containers/food/snacks/rationpack,
/obj/item/storage/backpack/duffelbag/med/surgery,
/turf/open/floor/plating,
/area/ship/storage)
"qm" = (
/obj/structure/rack,
/obj/item/borg/upgrade/ai,
/obj/item/borg/upgrade/ai,
/obj/item/borg/upgrade/ai,
/turf/open/floor/plating,
/area/ship/science/ai_chamber)
"qt" = (
/obj/effect/decal/cleanable/blood/footprints,
/obj/structure/rack,
/obj/item/clothing/mask/breath,
/obj/item/clothing/mask/breath,
/obj/item/clothing/mask/breath,
/obj/item/clothing/mask/breath,
/turf/open/floor/plating,
/area/ship/hallway/central)
"qS" = (
/turf/closed/wall/mineral/titanium/interior/blue,
/area/ship/science/robotics)
"ra" = (
/obj/machinery/computer/autopilot{
	dir = 8
	},
/turf/open/floor/plating,
/area/ship/bridge)
"rt" = (
/obj/machinery/atmospherics/components/unary/tank/air{
	dir = 1;
	piping_layer = 4
	},
/obj/item/pipe_dispenser,
/turf/open/floor/plating,
/area/ship/storage)
"rD" = (
/obj/effect/turf_decal/box,
/obj/structure/cable{
	icon_state = "1-2"
	},
/turf/open/floor/plasteel/patterned/cargo_one,
/area/ship/science/robotics)
"rH" = (
/obj/structure/cable{
	icon_state = "2-8"
	},
/obj/machinery/camera/autoname{
	dir = 8
	},
/turf/open/floor/plating,
/area/ship/bridge)
"sb" = (
/obj/machinery/power/apc/auto_name/north,
/obj/structure/cable{
	icon_state = "0-2"
	},
/turf/open/floor/plating,
/area/ship/bridge)
"sZ" = (
/obj/structure/cable{
	icon_state = "4-8"
	},
/obj/machinery/light/small{
	dir = 1
	},
/turf/open/floor/plating,
/area/ship/maintenance/aft)
"tC" = (
/obj/machinery/am_shielding,
/turf/open/floor/plating,
/area/ship/bridge)
"ub" = (
/turf/closed/wall/mineral/titanium/interior/blue,
/area/ship/crew/dorm)
"uu" = (
/obj/machinery/atmospherics/pipe/simple/orange/visible{
	dir = 5
	},
/obj/structure/cable{
	icon_state = "1-4"
	},
/turf/open/floor/plating,
/area/ship/maintenance/aft)
"uH" = (
/obj/structure/cable/yellow,
/obj/machinery/power/am_control_unit,
/turf/open/floor/plating,
/area/ship/bridge)
"uX" = (
/obj/machinery/light/small,
/obj/effect/decal/cleanable/dirt/dust,
/obj/machinery/camera/autoname{
	dir = 1
	},
/turf/open/floor/plating,
/area/ship/maintenance/aft)
"vC" = (
/obj/effect/turf_decal/rechargefloor,
/obj/item/radio/intercom{
	pixel_y = 22
	},
/obj/structure/mecha_wreckage/ripley,
/turf/open/floor/plasteel/patterned/cargo_one,
/area/ship/science/robotics)
"vM" = (
/obj/machinery/power/apc/auto_name/north,
/obj/structure/cable{
	icon_state = "0-2"
	},
/turf/open/floor/plating,
/area/ship/maintenance/aft)
"vY" = (
/obj/machinery/mecha_part_fabricator,
/turf/open/floor/mineral/titanium/tiled/blue,
/area/ship/science/robotics)
"we" = (
/obj/structure/cable{
	icon_state = "4-8"
	},
/turf/open/floor/plating,
/area/ship/crew/dorm)
"wi" = (
/obj/machinery/atmospherics/pipe/simple/orange/visible{
	dir = 4
	},
/obj/structure/cable{
	icon_state = "1-4"
	},
/turf/open/floor/plating,
/area/ship/maintenance/aft)
"wm" = (
/obj/structure/rack,
/obj/item/stack/cable_coil/white,
/obj/item/stack/cable_coil/white,
/turf/open/floor/plating,
/area/ship/science/ai_chamber)
"wP" = (
/obj/structure/cable{
	icon_state = "1-2"
	},
/turf/open/floor/plating,
/area/ship/bridge)
"wW" = (
/obj/machinery/power/terminal{
	dir = 8
	},
/obj/structure/cable,
/turf/open/floor/plating,
/area/ship/maintenance/aft)
"xe" = (
/obj/docking_port/mobile{
	can_move_docking_ports = 1;
	dir = 2;
	launch_status = 0;
	name = "Brilliant docking port";
	port_direction = 8;
	preferred_direction = 4
	},
/turf/closed/wall/mineral/titanium/interior/blue,
/area/ship/storage)
"xU" = (
/obj/structure/cable{
	icon_state = "4-8"
	},
/obj/machinery/power/apc/auto_name/north,
/obj/structure/cable{
	icon_state = "0-4"
	},
/turf/open/floor/plating,
/area/ship/storage)
"zZ" = (
/turf/open/floor/plating,
/area/ship/crew/dorm)
"Ae" = (
/obj/machinery/power/terminal{
	dir = 8
	},
/obj/structure/cable,
/obj/structure/cable{
	icon_state = "1-2"
	},
/turf/open/floor/plating,
/area/ship/maintenance/aft)
"An" = (
/obj/structure/closet/crate{
	name = "human mining crate"
	},
/obj/item/mining_scanner,
/obj/item/mining_scanner,
/obj/item/mining_scanner,
/obj/item/pickaxe,
/obj/item/pickaxe,
/obj/item/pickaxe,
/obj/item/storage/bag/ore,
/obj/item/storage/bag/ore,
/obj/item/storage/bag/ore,
/turf/open/floor/plating,
/area/ship/storage)
"AR" = (
/obj/machinery/suit_storage_unit/independent/engineering,
/turf/open/floor/plating,
/area/ship/hallway/central)
"Bf" = (
/obj/machinery/recharge_station,
/turf/open/floor/plating,
/area/ship/crew/dorm)
"Cc" = (
/obj/structure/grille/broken,
/obj/effect/decal/cleanable/glass,
/obj/effect/decal/cleanable/dirt/dust,
/obj/machinery/light/small{
	dir = 1
	},
/turf/open/floor/plating,
/area/ship/science/ai_chamber)
"Ct" = (
/obj/machinery/door/airlock/solgov,
/obj/structure/cable{
	icon_state = "4-8"
	},
/turf/open/floor/plating,
/area/ship/storage)
"CG" = (
/obj/machinery/power/terminal{
	dir = 8
	},
/obj/structure/cable{
	icon_state = "1-2"
	},
/obj/structure/cable{
	icon_state = "0-2"
	},
/turf/open/floor/plating,
/area/ship/maintenance/aft)
"CT" = (
/turf/open/floor/plating,
/area/ship/maintenance/aft)
"DC" = (
/obj/machinery/power/shuttle/engine/electric{
	dir = 4
	},
/obj/structure/cable{
	icon_state = "0-4"
	},
/turf/open/floor/plating,
/area/ship/external)
"DG" = (
/obj/machinery/power/shuttle/engine/fueled/plasma{
	dir = 4
	},
/turf/open/floor/plating,
/area/ship/external)
"DS" = (
/turf/closed/wall/mineral/titanium/interior/blue,
/area/ship/hallway/central)
"DW" = (
/obj/effect/decal/cleanable/blood/gibs/core,
/turf/open/floor/plating,
/area/ship/maintenance/aft)
"Et" = (
/obj/machinery/power/port_gen/pacman,
/turf/open/floor/plating,
/area/ship/storage)
"ER" = (
/obj/structure/cable{
	icon_state = "4-8"
	},
/obj/machinery/light/small{
	dir = 1
	},
/turf/open/floor/plating,
/area/ship/storage)
"FK" = (
/obj/machinery/mecha_part_fabricator{
	dir = 1
	},
/turf/open/floor/mineral/titanium/tiled/blue,
/area/ship/science/robotics)
"GA" = (
/obj/machinery/camera/autoname,
/turf/open/space/basic,
/area/ship/bridge)
"Hf" = (
/obj/machinery/door/airlock/solgov,
/obj/structure/cable{
	icon_state = "1-2"
	},
/turf/open/floor/plating,
/area/ship/hallway/central)
"Hx" = (
/obj/structure/cable{
	icon_state = "1-2"
	},
/turf/open/floor/plating,
/area/ship/science/ai_chamber)
"HL" = (
/obj/effect/turf_decal/rechargefloor,
/obj/machinery/power/apc/auto_name/north,
/obj/structure/cable{
	icon_state = "0-2"
	},
/turf/open/floor/plasteel/patterned/cargo_one,
/area/ship/science/robotics)
"Ic" = (
/turf/template_noop,
/area/template_noop)
"Ip" = (
/obj/effect/decal/cleanable/dirt/dust,
/turf/open/floor/plating,
/area/ship/crew/dorm)
"Jj" = (
/obj/structure/cable{
	icon_state = "1-4"
	},
/obj/effect/decal/cleanable/blood/footprints,
/turf/open/floor/plating,
/area/ship/hallway/central)
"Jl" = (
/obj/machinery/cryopod{
	dir = 4
	},
/turf/open/floor/plating,
/area/ship/crew/dorm)
"JP" = (
/obj/machinery/light/small,
/obj/effect/decal/cleanable/blood/gibs/body,
/obj/machinery/camera/autoname{
	dir = 1
	},
/turf/open/floor/plating,
/area/ship/science/ai_chamber)
"Kb" = (
/obj/machinery/light/small{
	dir = 1
	},
/turf/open/floor/plating,
/area/ship/maintenance/aft)
"Kn" = (
/obj/machinery/door/poddoor{
	id = "mech";
	name = "mech bay blast door"
	},
/obj/structure/fans/tiny,
/turf/open/floor/engine/hull/interior,
/area/ship/science/robotics)
"Ks" = (
/obj/machinery/computer/helm{
	dir = 8
	},
/turf/open/floor/plating,
/area/ship/bridge)
"KP" = (
/turf/open/floor/mineral/titanium/tiled/blue,
/area/ship/science/robotics)
"Lr" = (
/obj/machinery/power/apc/auto_name/north,
/obj/structure/cable{
	icon_state = "0-2"
	},
/turf/open/floor/plating,
/area/ship/crew/dorm)
"Ly" = (
/obj/machinery/computer/cryopod{
	pixel_y = 32
	},
/obj/machinery/light/small{
	dir = 1
	},
/turf/open/floor/plating,
/area/ship/crew/dorm)
"LC" = (
/obj/machinery/door/airlock/solgov,
/obj/structure/cable{
	icon_state = "1-2"
	},
/turf/open/floor/plating,
/area/ship/crew/dorm)
"LO" = (
/obj/machinery/camera/autoname{
	dir = 8
	},
/turf/open/space/basic,
/area/ship/maintenance/aft)
"LW" = (
/obj/machinery/camera/autoname{
	dir = 1
	},
/turf/open/space/basic,
/area/ship/maintenance/aft)
"Ma" = (
/obj/machinery/light/small,
/turf/open/floor/plating,
/area/ship/hallway/central)
"Mi" = (
/obj/machinery/droneDispenser,
/obj/structure/sign/poster/contraband/free_drone{
	pixel_x = 32
	},
/obj/item/radio/intercom{
	pixel_y = 22
	},
/turf/open/floor/plating,
/area/ship/science/ai_chamber)
"Mn" = (
/obj/item/storage/box/stockparts/basic,
/obj/item/circuitboard/machine/autolathe,
/obj/item/storage/toolbox/mechanical,
/obj/structure/closet/crate{
	name = "autolathe quickstart crate"
	},
/obj/item/stack/sheet/metal/five,
/obj/item/stack/sheet/glass{
	amount = 5
	},
/turf/open/floor/plating,
/area/ship/storage)
"MF" = (
/obj/machinery/atmospherics/pipe/simple/orange/visible{
	dir = 10
	},
/obj/structure/cable{
	icon_state = "2-8"
	},
/obj/structure/cable{
	icon_state = "4-8"
	},
/turf/open/floor/plating,
/area/ship/maintenance/aft)
"MO" = (
/obj/effect/decal/cleanable/dirt/dust,
/turf/open/floor/plating,
/area/ship/maintenance/aft)
"MP" = (
/obj/effect/turf_decal/rechargefloor,
/obj/structure/mecha_wreckage/gygax,
/turf/open/floor/plasteel/patterned/cargo_one,
/area/ship/science/robotics)
"Nh" = (
/turf/open/floor/plating,
/area/ship/storage)
"NN" = (
/obj/structure/cable{
	icon_state = "4-8"
	},
/turf/open/floor/plating,
/area/ship/science/ai_chamber)
"NT" = (
/obj/structure/cable{
	icon_state = "2-4"
	},
/obj/machinery/light/small{
	dir = 1
	},
/turf/open/floor/plating,
/area/ship/science/ai_chamber)
"Ov" = (
/obj/machinery/atmospherics/components/unary/tank/toxins,
/turf/open/floor/plating,
/area/ship/maintenance/aft)
"Pu" = (
/obj/machinery/light/small{
	dir = 8
	},
/turf/open/floor/plating,
/area/ship/storage)
"PF" = (
/obj/structure/cable{
	icon_state = "2-8"
	},
/obj/structure/cable{
	icon_state = "1-2"
	},
/turf/open/floor/plating,
/area/ship/bridge)
"PR" = (
/obj/machinery/atmospherics/pipe/simple/orange/visible,
/obj/structure/cable{
	icon_state = "1-2"
	},
/turf/open/floor/plating,
/area/ship/maintenance/aft)
"Qa" = (
/obj/machinery/camera/autoname{
	dir = 1
	},
/turf/open/space/basic,
/area/ship/bridge)
"Qc" = (
/obj/machinery/camera/autoname,
/turf/open/floor/plating,
/area/ship/crew/dorm)
"Qg" = (
/obj/machinery/atmospherics/pipe/simple/orange/visible{
	dir = 4
	},
/obj/structure/cable{
	icon_state = "2-4"
	},
/turf/open/floor/plating,
/area/ship/maintenance/aft)
"Qi" = (
/obj/effect/decal/cleanable/dirt/dust,
/turf/open/floor/plating,
/area/ship/hallway/central)
"Qo" = (
/obj/structure/cable{
	icon_state = "2-4"
	},
/turf/open/floor/plating,
/area/ship/crew/dorm)
"QF" = (
/obj/structure/cable{
	icon_state = "1-2"
	},
/obj/machinery/door/airlock/solgov,
/turf/open/floor/plating,
/area/ship/bridge)
"Rc" = (
/obj/machinery/camera/autoname,
/turf/open/space/basic,
/area/ship/science/ai_chamber)
"Rl" = (
/obj/structure/cable{
	icon_state = "4-8"
	},
/obj/structure/cable{
	icon_state = "1-4"
	},
/obj/machinery/camera/autoname{
	dir = 1
	},
/turf/open/floor/plating,
/area/ship/bridge)
"RH" = (
/obj/machinery/door/airlock/solgov,
/obj/structure/cable{
	icon_state = "4-8"
	},
/turf/open/floor/plating,
/area/ship/hallway/central)
"Sd" = (
/turf/open/floor/plating,
/area/ship/hallway/central)
"SI" = (
/obj/machinery/atmospherics/components/unary/shuttle/heater{
	dir = 4
	},
/obj/structure/window/reinforced/spawner/west,
/obj/machinery/door/window/eastright,
/turf/open/floor/plating,
/area/ship/maintenance/aft)
"SK" = (
/obj/structure/cable{
	icon_state = "4-8"
	},
/obj/machinery/light/small,
/turf/open/floor/plating,
/area/ship/bridge)
"SO" = (
/obj/structure/cable{
	icon_state = "1-4"
	},
/turf/open/floor/plating,
/area/ship/storage)
"Tc" = (
/obj/structure/cable{
	icon_state = "4-8"
	},
/obj/machinery/door/airlock/solgov,
/turf/open/floor/plating,
/area/ship/science/ai_chamber)
"To" = (
/turf/closed/wall/mineral/titanium/interior/blue,
/area/ship/science/ai_chamber)
"TG" = (
/obj/structure/cable{
	icon_state = "4-8"
	},
/turf/open/floor/mineral/titanium/tiled/blue,
/area/ship/science/robotics)
"TO" = (
/obj/structure/cable{
	icon_state = "1-2"
	},
/turf/open/floor/plating,
/area/ship/crew/dorm)
"TR" = (
/obj/structure/cable{
	icon_state = "1-2"
	},
/obj/effect/decal/cleanable/blood/footprints,
/turf/open/floor/plating,
/area/ship/hallway/central)
"Uc" = (
/turf/open/floor/plating,
/area/ship/bridge)
"Ue" = (
/obj/machinery/door/airlock/solgov,
/obj/structure/cable{
	icon_state = "1-2"
	},
/turf/open/floor/plating,
/area/ship/storage)
"Ul" = (
/obj/structure/cable{
	icon_state = "1-8"
	},
/turf/open/floor/plating,
/area/ship/maintenance/aft)
"Uu" = (
/obj/structure/tank_dispenser,
/turf/open/floor/plating,
/area/ship/hallway/central)
"UM" = (
/obj/structure/AIcore,
/turf/open/floor/plating,
/area/ship/science/ai_chamber)
"Vd" = (
/obj/structure/cable{
	icon_state = "1-8"
	},
/turf/open/floor/mineral/titanium/tiled/blue,
/area/ship/science/robotics)
"Ve" = (
/obj/machinery/light/small{
	dir = 1
	},
/obj/machinery/camera/autoname,
/turf/open/floor/plating,
/area/ship/hallway/central)
"Wp" = (
/obj/machinery/camera/autoname{
	dir = 1
	},
/turf/open/space/basic,
/area/ship/crew/dorm)
"XB" = (
/obj/machinery/light/small{
	dir = 4
	},
/obj/machinery/camera/autoname{
	dir = 8
	},
/turf/open/floor/plating,
/area/ship/crew/dorm)
"XJ" = (
/obj/machinery/camera/autoname{
	dir = 4
	},
/turf/open/space/basic,
/area/ship/bridge)
"XY" = (
/obj/machinery/holopad/emergency/command,
/obj/item/radio/intercom/wideband{
	pixel_y = 28
	},
/turf/open/floor/plating,
/area/ship/bridge)
"Yj" = (
/obj/machinery/atmospherics/pipe/manifold/orange/visible,
/obj/structure/cable{
	icon_state = "4-8"
	},
/turf/open/floor/plating,
/area/ship/maintenance/aft)
"Yz" = (
/obj/structure/chair/office{
	dir = 4
	},
/turf/open/floor/plating,
/area/ship/bridge)
"Zl" = (
/obj/machinery/light/small{
	dir = 1
	},
/turf/open/floor/plating,
/area/ship/crew/dorm)
"ZX" = (
/turf/closed/wall/mineral/titanium/interior/blue,
/area/ship/maintenance/aft)

(1,1,1) = {"
Ic
LO
ZX
DC
DC
DC
ZX
DG
ZX
Ic
Ic
ZX
DG
ZX
DC
DC
DC
ZX
jc
Ic
"}
(2,1,1) = {"
LW
ZX
ZX
hi
hi
hi
ZX
SI
ZX
Ic
Ic
ZX
SI
ZX
hi
hi
hi
ZX
ZX
oN
"}
(3,1,1) = {"
ZX
ZX
vM
nR
CG
CG
oL
wi
ZX
Ic
LO
ZX
Qg
oL
Ae
Ae
wW
uX
ZX
ZX
"}
(4,1,1) = {"
ZX
Kb
CT
CT
CT
cP
CT
er
ZX
ZX
ZX
ZX
fI
CT
CT
CT
MO
MO
CT
ZX
"}
(5,1,1) = {"
ZX
MO
MO
DW
CT
CT
CT
MF
uu
ZX
ZX
Ov
Yj
bM
bM
bM
bM
bM
bM
bM
"}
(6,1,1) = {"
ZX
ub
ub
ub
ub
ub
ub
sZ
ig
PR
PR
PR
eY
Ue
SO
bQ
Nh
Pu
qk
bM
"}
(7,1,1) = {"
ZX
ub
Jl
Ip
Ip
Qo
LC
Ul
CT
CT
MO
CT
aX
bM
fP
Nh
Nh
rt
bM
bM
"}
(8,1,1) = {"
Ic
ub
Ly
zZ
zZ
we
ub
DS
DS
DS
pW
DS
DS
bM
ER
Nh
Nh
Mn
bM
Ic
"}
(9,1,1) = {"
Ic
ub
ub
Qc
zZ
we
gg
DS
AR
AR
Sd
AR
AR
bM
xU
Nh
An
bM
bM
Ic
"}
(10,1,1) = {"
Ic
Ic
ub
Bf
zZ
we
zZ
DS
Ve
Qi
Qi
Sd
Ma
bM
fP
ku
Et
bM
Ic
Ic
"}
(11,1,1) = {"
Ic
Ic
ub
ub
Lr
ji
TO
Hf
TR
Jj
cZ
cZ
qt
bM
Ct
bM
xe
bM
Ic
Ic
"}
(12,1,1) = {"
Ic
Ic
Ic
ub
Zl
we
zZ
DS
Uu
hC
jo
aG
de
QF
PF
ir
gz
Ic
Ic
Ic
"}
(13,1,1) = {"
Ic
Ic
Wp
ub
zZ
we
qS
DS
DS
RH
DS
DS
DS
gz
Uc
cV
gz
GA
Ic
Ic
"}
(14,1,1) = {"
Ic
Ic
Ic
ub
zZ
we
qS
vY
KP
TG
KP
FK
gz
Uc
Uc
SK
gz
Ic
Ic
Ic
"}
(15,1,1) = {"
Ic
Ic
Ic
ub
XB
we
qS
HL
rD
Vd
pc
MP
gz
sb
wP
Rl
gz
gz
Ic
Ic
"}
(16,1,1) = {"
Ic
Ic
To
To
To
Tc
qS
gw
KP
KP
mt
oW
gz
Uc
Uc
cV
bU
gz
gz
gz
"}
(17,1,1) = {"
Ic
To
To
wm
dW
NN
qS
vC
pc
KP
fe
nD
gz
if
Uc
cV
tC
tC
tC
gz
"}
(18,1,1) = {"
Ic
To
NT
Hx
Hx
hY
qS
dE
lD
KP
KP
dE
gz
Uc
Uc
kx
tC
tC
tC
gz
"}
(19,1,1) = {"
Ic
To
eF
mb
df
JP
qS
qS
Kn
Kn
Kn
qS
gz
Uc
Uc
mA
tC
tC
tC
gz
"}
(20,1,1) = {"
Ic
To
Mi
mb
mb
kf
qm
To
fQ
Ic
Ic
gz
XY
Uc
mI
kx
oT
uH
gz
gz
"}
(21,1,1) = {"
Ic
To
To
lc
pu
lc
To
To
Ic
Ic
Ic
gz
gz
if
Uc
rH
mE
gz
gz
Ic
"}
(22,1,1) = {"
Ic
Ic
To
lz
ki
lz
To
Rc
Ic
Ic
Ic
Qa
gz
Yz
ra
gz
gz
gz
Ic
Ic
"}
(23,1,1) = {"
Ic
mf
To
To
Cc
To
To
Ic
Ic
Ic
Ic
Ic
gz
Ks
gz
gz
XJ
Ic
Ic
Ic
"}
(24,1,1) = {"
Ic
Ic
To
To
UM
To
To
Ic
Ic
Ic
Ic
Ic
gz
gz
gz
Ic
Ic
Ic
Ic
Ic
"}
(25,1,1) = {"
Ic
Ic
Ic
To
To
To
Ic
Ic
Ic
Ic
Ic
Ic
Ic
gz
Ic
Ic
Ic
Ic
Ic
Ic
"}
