//MAP CONVERTED BY dmm2tgm.py THIS HEADER COMMENT PREVENTS RECONVERSION, DO NOT REMOVE
"a" = (
/turf/template_noop,
/area/space)
"i" = (
/turf/closed/wall/mineral/titanium,
/area/space)
"v" = (
/turf/open/floor/plasteel/cult,
/area/space)
"y" = (
/obj/effect/turf_decal/corner/yellow/mono,
/turf/open/floor/plasteel,
/area/space)
"E" = (
/turf/open/floor/plasteel,
/area/space)
"H" = (
/obj/effect/turf_decal/corner/yellow/mono,
/turf/open/floor/plasteel/cult,
/area/space)
"Y" = (
/turf/open/floor/engine/cult,
/area/space)

(1,1,1) = {"
a
a
a
a
a
a
a
a
a
a
a
a
a
a
a
a
a
a
a
a
a
a
a
a
a
"}
(2,1,1) = {"
a
a
a
a
i
i
i
i
i
i
i
i
E
E
v
v
i
i
i
i
i
i
i
a
a
"}
(3,1,1) = {"
a
a
a
i
i
E
E
E
E
i
y
y
H
y
y
H
y
i
Y
Y
Y
Y
i
i
a
"}
(4,1,1) = {"
a
a
i
i
E
v
v
E
v
i
y
v
v
v
v
v
y
i
Y
Y
Y
Y
Y
i
a
"}
(5,1,1) = {"
a
a
i
E
v
v
E
E
v
i
y
v
E
v
v
E
y
i
Y
Y
Y
Y
Y
i
a
"}
(6,1,1) = {"
a
a
i
E
E
E
E
v
v
i
y
v
v
E
v
E
y
i
Y
Y
Y
Y
Y
i
a
"}
(7,1,1) = {"
a
i
i
i
i
i
v
E
E
i
y
v
v
v
E
E
y
i
Y
Y
Y
Y
Y
i
a
"}
(8,1,1) = {"
i
i
v
v
v
i
E
v
E
i
y
E
v
v
v
v
y
i
Y
Y
Y
Y
i
i
a
"}
(9,1,1) = {"
i
v
v
v
v
i
i
v
i
i
y
v
v
v
v
v
H
i
Y
Y
Y
i
i
a
a
"}
(10,1,1) = {"
i
v
v
v
v
i
v
E
E
i
y
v
E
v
E
v
H
i
Y
Y
Y
i
a
a
a
"}
(11,1,1) = {"
i
v
v
v
v
v
v
v
v
v
H
v
v
v
v
v
y
Y
Y
Y
Y
i
a
a
a
"}
(12,1,1) = {"
i
v
v
v
v
i
v
E
v
i
H
v
v
v
E
E
y
i
Y
Y
Y
i
a
a
a
"}
(13,1,1) = {"
i
v
v
v
v
i
i
E
i
i
y
E
v
E
v
v
y
i
Y
Y
Y
i
i
a
a
"}
(14,1,1) = {"
i
i
v
v
v
i
E
E
E
i
y
E
E
v
E
v
y
i
Y
Y
Y
Y
i
i
a
"}
(15,1,1) = {"
a
i
i
i
i
i
E
E
E
i
y
v
E
v
v
E
y
i
Y
Y
Y
Y
Y
i
a
"}
(16,1,1) = {"
a
a
i
E
E
E
E
v
E
i
y
v
v
E
E
v
y
i
Y
Y
Y
Y
Y
i
a
"}
(17,1,1) = {"
a
a
i
E
E
v
v
E
E
i
y
v
E
v
v
v
H
i
Y
Y
Y
Y
Y
i
a
"}
(18,1,1) = {"
a
a
i
i
E
E
E
v
v
i
y
v
v
E
v
v
H
i
Y
Y
Y
Y
Y
i
a
"}
(19,1,1) = {"
a
a
a
i
i
E
E
E
v
i
y
y
H
H
y
y
y
i
Y
Y
Y
Y
i
i
a
"}
(20,1,1) = {"
a
a
a
a
i
i
i
i
i
i
i
i
v
v
E
E
i
i
i
i
i
i
i
a
a
"}
(21,1,1) = {"
a
a
a
a
a
a
a
a
a
a
a
a
a
a
a
a
a
a
a
a
a
a
a
a
a
"}
