"ad" = (/obj/structure/table,/obj/item/forcefield_projector,/obj/item/forcefield_projector,/turf/open/floor/plasteel/dark,/area/ship/construction)
"af" = (/obj/machinery/rnd/production/circuit_imprinter,/obj/machinery/light,/turf/open/floor/plasteel/dark,/area/ship/science)
"al" = (/obj/structure/table,/obj/item/debug/human_spawner,/obj/item/gun/magic/wand/resurrection/debug,/obj/item/gun/magic/wand/death/debug,/obj/item/hierophant_club,/obj/item/gun/magic/bloodchill,/obj/item/gun/magic/hook,/obj/item/gun/magic/tentacle,/obj/item/legion_staff,/obj/item/reagent_containers/glass/bottle/potion/flight,/obj/machinery/light{dir = 1},/turf/open/floor/plasteel/dark,/area/ship/construction)
"aC" = (/turf/closed/wall/r_wall/syndicate,/area/ship/science)
"aH" = (/obj/machinery/vending/wardrobe/bar_wardrobe,/turf/open/floor/plasteel/dark,/area/ship/bridge)
"bv" = (/obj/machinery/vending/syndichem,/turf/open/floor/plasteel/dark,/area/ship/science)
"bP" = (/obj/structure/rack,/obj/item/dnainjector/chavmut,/obj/item/dnainjector/clumsymut,/obj/item/dnainjector/coughmut,/obj/item/dnainjector/elvismut,/obj/item/dnainjector/deafmut,/obj/item/dnainjector/glassesmut,/obj/item/dnainjector/mutemut,/obj/item/dnainjector/paranoia,/obj/item/dnainjector/spastic,/obj/item/dnainjector/stuttmut,/obj/item/dnainjector/swedishmut,/obj/item/dnainjector/tourmut,/obj/item/dnainjector/void,/obj/item/dnainjector/unintelligiblemut,/turf/open/floor/plasteel/dark,/area/ship/cargo)
"cn" = (/obj/machinery/ore_silo,/obj/machinery/light,/turf/open/floor/plasteel/dark,/area/ship/engineering/engine)
"cq" = (/obj/structure/rack,/obj/item/gun/blastcannon/debug,/obj/item/gun/energy/beam_rifle/debug,/obj/item/gun/energy/meteorgun,/obj/item/gun/energy/chrono_gun,/obj/item/gun/energy/shrink_ray,/obj/item/minigunpack,/turf/open/floor/plasteel/dark,/area/ship/cargo)
"ct" = (/obj/structure/cable{icon_state = "1-2"},/turf/open/floor/plasteel/dark,/area/ship/construction)
"cu" = (/obj/machinery/portable_atmospherics/pump,/turf/open/floor/plasteel/dark,/area/ship/engineering/engine)
"cJ" = (/obj/item/circuitboard/machine/rdserver,/obj/structure/frame,/turf/open/floor/plasteel/dark,/area/ship/science)
"cT" = (/obj/structure/cable{icon_state = "1-8"},/obj/structure/cable{icon_state = "4-8"},/turf/open/floor/plasteel/dark,/area/ship/science)
"dp" = (/obj/machinery/airalarm{dir = 4; pixel_x = -24},/turf/open/floor/plasteel/dark,/area/ship/construction)
"dF" = (/obj/machinery/computer/operating,/turf/open/floor/plasteel/dark,/area/ship/science)
"ex" = (/obj/structure/cable{icon_state = "1-2"},/turf/open/floor/plasteel/dark,/area/ship/engineering/engine)
"eA" = (/obj/machinery/light{dir = 1},/turf/open/floor/plasteel/dark,/area/ship/construction)
"eX" = (/obj/structure/rack,/obj/item/dnainjector/antiacidflesh,/obj/item/dnainjector/antiantenna,/obj/item/dnainjector/antiblind,/obj/item/dnainjector/antichameleon,/obj/item/dnainjector/antichav,/obj/item/dnainjector/anticlumsy,/obj/item/dnainjector/anticough,/obj/item/dnainjector/anticryokinesis,/obj/item/dnainjector/antideaf,/obj/item/dnainjector/antidwarf,/obj/item/dnainjector/antielvis,/obj/item/dnainjector/antiepi,/obj/item/dnainjector/antifire,/obj/item/dnainjector/antigeladikinesis,/obj/item/dnainjector/antigigantism,/obj/item/dnainjector/antiglasses,/obj/item/dnainjector/antiglow,/obj/item/dnainjector/antihulk,/obj/item/dnainjector/antiinsulated,/obj/item/dnainjector/antilasereyes,/obj/item/dnainjector/antimindread,/obj/item/dnainjector/antimute,/obj/item/dnainjector/antiolfaction,/obj/item/dnainjector/antiparanoia,/obj/item/dnainjector/antiradioactive,/obj/item/dnainjector/antishock,/obj/item/dnainjector/antispacialinstability,/obj/item/dnainjector/antispastic,/obj/item/dnainjector/antistutt,/obj/item/dnainjector/antiswedish,/obj/item/dnainjector/antitele,/obj/item/dnainjector/antithermal,/obj/item/dnainjector/antitour,/obj/item/dnainjector/antitwoleftfeet,/obj/item/dnainjector/antiunintelligible,/obj/item/dnainjector/antivoid,/obj/item/dnainjector/antiwacky,/obj/item/dnainjector/antixray,/obj/item/dnainjector/removeantiglow,/obj/item/dnainjector/removeglow,/turf/open/floor/plasteel/dark,/area/ship/cargo)
"fs" = (/obj/machinery/computer/atmos_alert{dir = 8},/turf/open/floor/plasteel/dark,/area/ship/bridge)
"fv" = (/obj/machinery/airalarm{pixel_y = 24},/turf/open/floor/plasteel/dark,/area/ship/engineering/engine)
"fC" = (/obj/machinery/portable_atmospherics/scrubber,/obj/machinery/light{dir = 1},/turf/open/floor/plasteel/dark,/area/ship/engineering/engine)
"fL" = (/obj/effect/landmark/start/chief_engineer,/turf/open/floor/plasteel/dark,/area/ship/construction)
"gb" = (/obj/machinery/power/apc/auto_name/west,/obj/structure/cable{icon_state = "0-2"},/obj/machinery/vending/wardrobe/engi_wardrobe,/turf/open/floor/plasteel/dark,/area/ship/bridge)
"gt" = (/obj/structure/rack,/obj/item/encryptionkey/heads/captain,/obj/item/encryptionkey/heads/ce,/obj/item/encryptionkey/heads/cmo,/obj/item/encryptionkey/heads/head_of_personnel,/obj/item/encryptionkey/heads/hos,/obj/item/encryptionkey/heads/rd,/turf/open/floor/plasteel/dark,/area/ship/cargo)
"gD" = (/obj/structure/cable{icon_state = "2-8"},/obj/structure/cable{icon_state = "1-8"},/turf/open/floor/plasteel/dark,/area/ship/construction)
"gS" = (/obj/structure/rack,/obj/item/dualsaber,/obj/item/energy_katana,/obj/item/fireaxe,/obj/item/mjollnir,/obj/item/nullrod,/obj/item/nullrod,/turf/open/floor/plasteel/dark,/area/ship/cargo)
"hC" = (/obj/structure/table,/turf/open/floor/plasteel/dark,/area/ship/science)
"is" = (/obj/structure/rack,/obj/item/grenade/clusterbuster/antiweed,/obj/item/grenade/clusterbuster/cleaner,/obj/item/grenade/clusterbuster/clf3,/obj/item/grenade/clusterbuster/emp,/obj/item/grenade/clusterbuster/facid,/obj/item/grenade/clusterbuster/inferno,/obj/item/grenade/clusterbuster/metalfoam,/obj/item/grenade/clusterbuster/slime,/turf/open/floor/plasteel/dark,/area/ship/cargo)
"iR" = (/obj/machinery/power/smes/magical{desc = "What."; name = "Bullshitinator 5000 SMES and RTG Bank Combined"},/turf/open/floor/plasteel/dark,/area/ship/engineering/engine)
"jc" = (/obj/machinery/vending/wardrobe/jani_wardrobe,/turf/open/floor/plasteel/dark,/area/ship/bridge)
"ju" = (/obj/structure/table,/obj/item/construction/rcd/arcd,/obj/item/rcd_upgrade/frames,/obj/item/rcd_ammo/large,/obj/item/rcd_ammo/large,/turf/open/floor/plasteel/dark,/area/ship/science)
"jW" = (/obj/machinery/vending/wardrobe/science_wardrobe,/turf/open/floor/plasteel/dark,/area/ship/bridge)
"kc" = (/obj/structure/table,/obj/item/disk/tech_disk/debug,/turf/open/floor/plasteel/dark,/area/ship/science)
"kq" = (/obj/machinery/cryopod,/obj/machinery/computer/cryopod{pixel_y = 32},/turf/open/floor/plasteel/dark,/area/ship/engineering/engine)
"kL" = (/obj/effect/spawner/structure/window/reinforced,/turf/open/floor/plating,/area/ship/bridge)
"kV" = (/obj/machinery/computer/camera_advanced/syndie{dir = 8},/turf/open/floor/plasteel/dark,/area/ship/bridge)
"lf" = (/obj/machinery/portable_atmospherics/scrubber,/turf/open/floor/plasteel/dark,/area/ship/engineering/engine)
"lo" = (/obj/structure/rack,/obj/item/gun/energy/decloner,/obj/item/gun/energy/printer/commando,/obj/item/gun/energy/printer,/obj/item/gun/ballistic/rocketlauncher/unrestricted,/obj/item/gun/ballistic/minigun,/turf/open/floor/plasteel/dark,/area/ship/cargo)
"lp" = (/obj/structure/chair/comfy/black{dir = 4},/obj/effect/landmark/start/captain,/turf/open/floor/plasteel/dark,/area/ship/bridge)
"lE" = (/obj/machinery/computer/autopilot{dir = 8},/turf/open/floor/plasteel/dark,/area/ship/bridge)
"lL" = (/obj/machinery/modular_computer/console/preset/command{dir = 8},/turf/open/floor/plasteel/dark,/area/ship/bridge)
"lO" = (/obj/structure/cable{icon_state = "1-2"},/obj/machinery/vending/wardrobe/det_wardrobe,/turf/open/floor/plasteel/dark,/area/ship/bridge)
"mr" = (/obj/structure/rack,/obj/item/clothing/suit/space/hardsuit/syndi/elite/debug,/obj/item/clothing/glasses/debug,/turf/open/floor/plasteel/dark,/area/ship/cargo)
"mE" = (/obj/machinery/power/shuttle/engine/void{dir = 8},/obj/structure/window/reinforced/spawner{dir = 8},/obj/structure/window/reinforced/spawner,/obj/structure/window/reinforced/spawner{dir = 1},/turf/open/floor/plasteel/dark,/area/ship/engineering/engine)
"ny" = (/obj/structure/table,/obj/item/extinguisher/advanced,/obj/item/extinguisher/advanced,/turf/open/floor/plasteel/dark,/area/ship/construction)
"po" = (/obj/docking_port/mobile{dir = 2},/turf/open/space/basic,/area/space)
"pN" = (/obj/structure/cable{icon_state = "1-2"},/turf/open/floor/plasteel/dark,/area/ship/cargo)
"qk" = (/obj/machinery/power/apc/auto_name/south,/obj/structure/cable,/turf/open/floor/plasteel/dark,/area/ship/engineering/engine)
"qU" = (/obj/structure/cable{icon_state = "2-4"},/obj/structure/cable{icon_state = "1-2"},/turf/open/floor/plasteel/dark,/area/ship/engineering/engine)
"qX" = (/obj/machinery/chem_dispenser/fullupgrade,/turf/open/floor/plasteel/dark,/area/ship/science)
"rh" = (/obj/machinery/vending/wardrobe/chap_wardrobe,/turf/open/floor/plasteel/dark,/area/ship/bridge)
"rY" = (/turf/closed/wall/r_wall/syndicate,/area/ship/construction)
"sy" = (/obj/machinery/rnd/production/protolathe,/turf/open/floor/plasteel/dark,/area/ship/science)
"tc" = (/obj/machinery/computer/rdconsole{dir = 1},/turf/open/floor/plasteel/dark,/area/ship/science)
"tD" = (/obj/effect/landmark/start/research_director,/turf/open/floor/plasteel/dark,/area/ship/science)
"uP" = (/obj/machinery/chem_heater,/turf/open/floor/plasteel/dark,/area/ship/science)
"vu" = (/obj/structure/rack,/obj/item/grenade/chem_grenade/antiweed,/obj/item/grenade/chem_grenade/antiweed,/obj/item/grenade/chem_grenade/bioterrorfoam,/obj/item/grenade/chem_grenade/bioterrorfoam,/obj/item/grenade/chem_grenade/cleaner,/obj/item/grenade/chem_grenade/cleaner,/obj/item/grenade/chem_grenade/clf3,/obj/item/grenade/chem_grenade/clf3,/obj/item/grenade/chem_grenade/colorful,/obj/item/grenade/chem_grenade/colorful,/obj/item/grenade/chem_grenade/cryo,/obj/item/grenade/chem_grenade/cryo,/obj/item/grenade/chem_grenade/ez_clean,/obj/item/grenade/chem_grenade/ez_clean,/obj/item/grenade/chem_grenade/facid,/obj/item/grenade/chem_grenade/facid,/obj/item/grenade/chem_grenade/ghostbuster,/obj/item/grenade/chem_grenade/ghostbuster,/obj/item/grenade/chem_grenade/glitter,/obj/item/grenade/chem_grenade/glitter,/obj/item/grenade/chem_grenade/glitter/pink,/obj/item/grenade/chem_grenade/glitter/pink,/obj/item/grenade/chem_grenade/holy,/obj/item/grenade/chem_grenade/holy,/obj/item/grenade/chem_grenade/incendiary,/obj/item/grenade/chem_grenade/incendiary,/obj/item/grenade/chem_grenade/metalfoam,/obj/item/grenade/chem_grenade/metalfoam,/obj/item/grenade/chem_grenade/smart_metal_foam,/obj/item/grenade/chem_grenade/smart_metal_foam,/obj/item/grenade/chem_grenade/teargas,/obj/item/grenade/chem_grenade/teargas,/obj/item/grenade/chem_grenade/teargas/moustache,/obj/item/grenade/chem_grenade/teargas/moustache,/obj/item/grenade/chem_grenade/tuberculosis,/obj/item/grenade/chem_grenade/tuberculosis,/obj/item/grenade/flashbang,/obj/item/grenade/flashbang,/turf/open/floor/plasteel/dark,/area/ship/cargo)
"vP" = (/obj/structure/rack,/obj/structure/cable{icon_state = "0-8"},/obj/item/grenade/clusterbuster/spawner_manhacks,/obj/item/grenade/clusterbuster/spawner_spesscarp,/obj/item/grenade/clusterbuster/syndieminibomb,/turf/open/floor/plasteel/dark,/area/ship/cargo)
"xm" = (/obj/machinery/vending/wardrobe/atmos_wardrobe,/obj/machinery/light{dir = 8},/turf/open/floor/plasteel/dark,/area/ship/bridge)
"xC" = (/obj/machinery/navbeacon/wayfinding/tools,/turf/closed/wall/r_wall/syndicate,/area/ship/construction)
"yN" = (/obj/machinery/power/apc/auto_name/east,/obj/structure/cable,/turf/open/floor/plasteel/dark,/area/ship/science)
"zF" = (/obj/structure/rack,/obj/item/encryptionkey/heads/lieutenant,/obj/item/encryptionkey/headset_cent,/obj/item/encryptionkey/solgov,/obj/item/encryptionkey/syndicate,/obj/item/encryptionkey/wideband,/turf/open/floor/plasteel/dark,/area/ship/cargo)
"zL" = (/obj/structure/table/optable,/obj/machinery/shower{dir = 4},/obj/machinery/defibrillator_mount{pixel_y = 29},/turf/open/floor/plasteel/dark,/area/ship/science)
"BN" = (/obj/structure/cable{icon_state = "1-2"},/obj/structure/table,/obj/machinery/chem_dispenser/abductor,/turf/open/floor/plasteel/dark,/area/ship/science)
"Cr" = (/turf/closed/wall/r_wall/syndicate,/area/ship/cargo)
"CH" = (/obj/machinery/airalarm{dir = 4; pixel_x = -24},/obj/machinery/vending/wardrobe/chef_wardrobe,/turf/open/floor/plasteel/dark,/area/ship/bridge)
"CO" = (/obj/structure/cable{icon_state = "1-2"},/obj/structure/cable{icon_state = "2-4"},/turf/open/floor/plasteel/dark,/area/ship/engineering/engine)
"CZ" = (/obj/structure/table,/turf/open/floor/plasteel/dark,/area/ship/construction)
"Db" = (/obj/structure/cable{icon_state = "1-2"},/turf/open/floor/plasteel/dark,/area/ship/science)
"Dm" = (/obj/structure/rack,/turf/open/floor/plasteel/dark,/area/ship/cargo)
"DP" = (/obj/structure/cable{icon_state = "1-2"},/turf/open/floor/plasteel/dark,/area/ship/bridge)
"DQ" = (/turf/open/floor/plasteel/dark,/area/ship/construction)
"DX" = (/obj/structure/rack,/obj/item/gang_induction_package,/obj/item/book/granter/spell,/obj/item/book/granter/martial/carp,/obj/item/book/granter/martial/cqc,/obj/item/book/granter/martial/plasma_fist,/obj/item/codespeak_manual,/turf/open/floor/plasteel/dark,/area/ship/cargo)
"Ej" = (/obj/machinery/vending/wardrobe/hydro_wardrobe,/turf/open/floor/plasteel/dark,/area/ship/bridge)
"EK" = (/obj/machinery/vending/wardrobe/sec_wardrobe,/turf/open/floor/plasteel/dark,/area/ship/bridge)
"EN" = (/obj/structure/rack,/obj/item/dnainjector/cryokinesis,/obj/item/dnainjector/epimut,/obj/item/dnainjector/firemut,/obj/item/dnainjector/geladikinesis,/obj/item/dnainjector/glow,/obj/item/dnainjector/radioactive,/obj/item/dnainjector/shock,/turf/open/floor/plasteel/dark,/area/ship/cargo)
"Fm" = (/turf/open/space/basic,/area/space)
"Fr" = (/obj/machinery/power/apc/auto_name/east,/obj/structure/cable{icon_state = "0-8"},/obj/structure/rack,/obj/item/gun/energy/goatgun,/turf/open/floor/plasteel/dark,/area/ship/cargo)
"FT" = (/obj/structure/table,/obj/machinery/airalarm{dir = 1; pixel_y = -24},/obj/item/storage/box/beakers/bluespace,/obj/item/reagent_containers/syringe/bluespace,/obj/item/reagent_containers/syringe/bluespace,/obj/machinery/light,/turf/open/floor/plasteel/dark,/area/ship/science)
"Gf" = (/obj/machinery/vending/security,/turf/open/floor/plasteel/dark,/area/ship/construction)
"GC" = (/obj/structure/cable{icon_state = "1-8"},/turf/open/floor/plasteel/dark,/area/ship/bridge)
"GH" = (/obj/machinery/vending/wardrobe/gene_wardrobe,/obj/machinery/light{dir = 8},/turf/open/floor/plasteel/dark,/area/ship/bridge)
"Hd" = (/obj/structure/table,/obj/item/storage/belt/military/abductor/full,/obj/item/debug/omnitool,/turf/open/floor/plasteel/dark,/area/ship/science)
"Hx" = (/obj/machinery/light,/turf/open/floor/plasteel/dark,/area/ship/cargo)
"HC" = (/obj/machinery/light,/turf/open/floor/plasteel/dark,/area/ship/construction)
"Iy" = (/obj/machinery/vending/wardrobe/viro_wardrobe,/turf/open/floor/plasteel/dark,/area/ship/bridge)
"IO" = (/obj/item/stack/sheet/bluespace_crystal/fifty,/obj/item/stack/sheet/bluespace_crystal/fifty,/obj/item/stack/sheet/bluespace_crystal/fifty,/obj/item/stack/sheet/glass/fifty,/obj/item/stack/sheet/glass/fifty,/obj/item/stack/sheet/glass/fifty,/obj/item/stack/sheet/metal/fifty,/obj/item/stack/sheet/metal/fifty,/obj/item/stack/sheet/metal/fifty,/obj/item/stack/sheet/mineral/bananium/five,/obj/item/stack/sheet/mineral/bananium/five,/obj/item/stack/sheet/mineral/bananium/five,/obj/item/stack/sheet/mineral/bananium/five,/obj/item/stack/sheet/mineral/bananium/five,/obj/item/stack/sheet/mineral/bananium/five,/obj/item/stack/sheet/mineral/bananium/five,/obj/item/stack/sheet/mineral/bananium/five,/obj/item/stack/sheet/mineral/bananium/five,/obj/item/stack/sheet/mineral/bananium/five,/obj/item/stack/sheet/mineral/diamond/fifty,/obj/item/stack/sheet/mineral/diamond/fifty,/obj/item/stack/sheet/mineral/diamond/fifty,/obj/item/stack/sheet/mineral/gold/fifty,/obj/item/stack/sheet/mineral/gold/fifty,/obj/item/stack/sheet/mineral/gold/fifty,/obj/item/stack/sheet/mineral/plasma/fifty,/obj/item/stack/sheet/mineral/plasma/fifty,/obj/item/stack/sheet/mineral/plasma/fifty,/obj/item/stack/sheet/mineral/titanium/fifty,/obj/item/stack/sheet/mineral/titanium/fifty,/obj/item/stack/sheet/mineral/titanium/fifty,/obj/item/stack/sheet/mineral/uranium/fifty,/obj/item/stack/sheet/mineral/uranium/fifty,/obj/item/stack/sheet/mineral/uranium/fifty,/turf/open/floor/plasteel/dark,/area/ship/engineering/engine)
"Jm" = (/turf/open/floor/plasteel/dark,/area/ship/science)
"Jw" = (/turf/open/floor/plasteel/dark,/area/ship/bridge)
"JG" = (/obj/machinery/vending/wardrobe/robo_wardrobe,/turf/open/floor/plasteel/dark,/area/ship/bridge)
"JO" = (/obj/machinery/vending/wardrobe/cargo_wardrobe,/turf/open/floor/plasteel/dark,/area/ship/bridge)
"Lf" = (/obj/structure/cable{icon_state = "4-8"},/turf/open/floor/plasteel/dark,/area/ship/construction)
"LE" = (/obj/structure/cable{icon_state = "1-2"},/obj/structure/cable{icon_state = "2-4"},/turf/open/floor/plasteel/dark,/area/ship/construction)
"LM" = (/turf/open/floor/plasteel/dark,/area/ship/engineering/engine)
"LU" = (/obj/structure/cable{icon_state = "4-8"},/turf/open/floor/plasteel/dark,/area/ship/science)
"Mp" = (/obj/machinery/computer/cargo/express,/turf/open/floor/plasteel/dark,/area/ship/construction)
"MD" = (/obj/machinery/airalarm{dir = 1; pixel_y = -24},/turf/open/floor/plasteel/dark,/area/ship/engineering/engine)
"Nl" = (/obj/structure/table,/obj/item/storage/box/debugtools,/turf/open/floor/plasteel/dark,/area/ship/construction)
"Nu" = (/obj/structure/cable{icon_state = "4-8"},/turf/open/floor/plasteel/dark,/area/ship/engineering/engine)
"NF" = (/obj/structure/rack,/obj/item/dnainjector/dwarf,/obj/item/dnainjector/firebreath,/obj/item/dnainjector/gigantism,/obj/item/dnainjector/h2m,/obj/item/dnainjector/hulkmut,/obj/item/dnainjector/insulated,/obj/item/dnainjector/lasereyesmut,/obj/item/dnainjector/m2h,/obj/item/dnainjector/mindread,/obj/item/dnainjector/telemut,/obj/item/dnainjector/thermal,/obj/item/dnainjector/xraymut,/turf/open/floor/plasteel/dark,/area/ship/cargo)
"OY" = (/obj/structure/cable{icon_state = "4-8"},/turf/open/floor/plasteel/dark,/area/ship/bridge)
"Pg" = (/obj/structure/rack,/obj/item/encryptionkey/ai,/obj/item/encryptionkey/binary,/turf/open/floor/plasteel/dark,/area/ship/cargo)
"PO" = (/obj/structure/table,/obj/item/gun_voucher,/obj/item/gun_voucher,/obj/item/gun_voucher,/obj/item/gun_voucher,/obj/item/gun_voucher/solgov,/obj/item/gun_voucher/solgov,/obj/item/gun_voucher/solgov,/obj/item/gun_voucher/solgov,/obj/item/gun_voucher/syndicate,/obj/item/gun_voucher/syndicate,/obj/item/gun_voucher/syndicate,/obj/item/gun_voucher/syndicate,/turf/open/floor/plasteel/dark,/area/ship/construction)
"QI" = (/obj/machinery/computer/apc_control{dir = 8},/turf/open/floor/plasteel/dark,/area/ship/bridge)
"QL" = (/obj/machinery/airalarm{pixel_y = 24},/obj/machinery/light{dir = 1},/turf/open/floor/plasteel/dark,/area/ship/cargo)
"QR" = (/obj/structure/rack,/obj/item/firing_pin,/obj/item/firing_pin,/obj/item/firing_pin,/obj/item/firing_pin,/obj/item/firing_pin,/obj/item/firing_pin,/obj/item/firing_pin,/obj/item/firing_pin,/obj/item/firing_pin,/obj/item/firing_pin,/obj/item/firing_pin,/obj/item/firing_pin,/obj/item/firing_pin,/obj/item/firing_pin,/turf/open/floor/plasteel/dark,/area/ship/cargo)
"Rv" = (/obj/machinery/light{dir = 1},/turf/open/floor/plasteel/dark,/area/ship/engineering/engine)
"Sb" = (/obj/machinery/vending/wardrobe/law_wardrobe,/turf/open/floor/plasteel/dark,/area/ship/bridge)
"Tl" = (/obj/structure/rack,/obj/item/dnainjector/olfaction,/obj/item/dnainjector/spacialinstability,/turf/open/floor/plasteel/dark,/area/ship/cargo)
"Tu" = (/obj/structure/cable{icon_state = "2-4"},/turf/open/floor/plasteel/dark,/area/ship/cargo)
"TT" = (/obj/structure/cable{icon_state = "1-2"},/obj/structure/table,/obj/machinery/chem_dispenser/drinks/beer/fullupgrade,/turf/open/floor/plasteel/dark,/area/ship/science)
"Ue" = (/obj/effect/landmark/start/cyborg,/turf/open/floor/plasteel/dark,/area/ship/construction)
"Uo" = (/turf/open/floor/plasteel/dark,/area/ship/cargo)
"UB" = (/obj/machinery/power/apc/auto_name/north,/obj/structure/cable{icon_state = "0-2"},/turf/open/floor/plasteel/dark,/area/ship/engineering/engine)
"UZ" = (/obj/machinery/vending/wardrobe/chem_wardrobe,/obj/machinery/light{dir = 8},/turf/open/floor/plasteel/dark,/area/ship/bridge)
"Va" = (/obj/structure/cable{icon_state = "2-8"},/obj/structure/cable{icon_state = "4-8"},/turf/open/floor/plasteel/dark,/area/ship/science)
"Vg" = (/obj/structure/cable{icon_state = "4-8"},/obj/item/storage/backpack/duffelbag/med/surgery,/obj/item/defibrillator/loaded,/turf/open/floor/plasteel/dark,/area/ship/science)
"VB" = (/obj/structure/cable{icon_state = "1-2"},/obj/structure/table,/obj/machinery/chem_dispenser/drinks/fullupgrade,/turf/open/floor/plasteel/dark,/area/ship/science)
"VM" = (/obj/machinery/navbeacon/wayfinding/tools,/turf/open/floor/plasteel/dark,/area/ship/construction)
"Wc" = (/obj/structure/cable{icon_state = "4-8"},/turf/open/floor/plasteel/dark,/area/ship/cargo)
"Wg" = (/obj/structure/rack,/obj/item/uplink/debug,/turf/open/floor/plasteel/dark,/area/ship/cargo)
"Wl" = (/obj/machinery/light{dir = 8},/turf/open/floor/plasteel/dark,/area/ship/construction)
"Ws" = (/obj/machinery/light,/turf/open/floor/plasteel/dark,/area/ship/engineering/engine)
"WN" = (/obj/structure/table,/obj/item/geiger_counter,/turf/open/floor/plasteel/dark,/area/ship/construction)
"WU" = (/obj/machinery/power/terminal{dir = 4},/obj/structure/cable{icon_state = "0-8"},/turf/open/floor/plasteel/dark,/area/ship/engineering/engine)
"Xm" = (/obj/machinery/power/apc/auto_name/west,/obj/structure/cable{icon_state = "0-4"},/turf/open/floor/plasteel/dark,/area/ship/construction)
"Xx" = (/obj/structure/rack,/obj/item/gps/visible_debug,/turf/open/floor/plasteel/dark,/area/ship/cargo)
"XF" = (/turf/closed/wall/r_wall/syndicate,/area/ship/engineering/engine)
"Yf" = (/obj/structure/cable{icon_state = "1-2"},/obj/machinery/vending/wardrobe/curator_wardrobe,/obj/machinery/light{dir = 8},/turf/open/floor/plasteel/dark,/area/ship/bridge)
"Yq" = (/obj/structure/table,/turf/open/floor/plasteel/dark,/area/ship/bridge)
"Yx" = (/obj/machinery/computer/helm{dir = 8},/turf/open/floor/plasteel/dark,/area/ship/bridge)
"YE" = (/obj/machinery/chem_master,/turf/open/floor/plasteel/dark,/area/ship/science)
"Za" = (/obj/machinery/vending/security/marine/solgov,/turf/open/floor/plasteel/dark,/area/ship/construction)
"ZB" = (/obj/machinery/vending/wardrobe/medi_wardrobe,/obj/machinery/light{dir = 8},/turf/open/floor/plasteel/dark,/area/ship/bridge)
"ZJ" = (/obj/structure/rack,/obj/item/encryptionkey/headset_cargo,/obj/item/encryptionkey/headset_eng,/obj/item/encryptionkey/headset_com,/obj/item/encryptionkey/headset_med,/obj/item/encryptionkey/headset_medsci,/obj/item/encryptionkey/headset_medsec,/obj/item/encryptionkey/headset_mining,/obj/item/encryptionkey/headset_rob,/obj/item/encryptionkey/headset_sci,/obj/item/encryptionkey/headset_sec,/obj/item/encryptionkey/headset_service,/obj/item/encryptionkey/headset_srvmed,/obj/item/encryptionkey/headset_srvsec,/turf/open/floor/plasteel/dark,/area/ship/cargo)
"ZZ" = (/obj/machinery/light{dir = 1},/turf/open/floor/plasteel/dark,/area/ship/cargo)

(1,1,1) = {"
FmXFXFXFXFXFXFXFXFXFFmFmpoFmFmFmFmFmFmFmkLkLkLkLkL
FmFmmERvLMUBLMLMfCXFFmFmFmFmFmFmFmFmFmFmkLJGjWEKkL
FmFmmELMLMexLMLMcuXFFmCrCrCrCrCrCrCrCrCrkLJwJwJwkL
FmFmmELMMDCONuWUiRXFFmCreXZZDXUoPgQLgSCrZBJwJwYqkL
FmXFXFXFXFexLMXFXFXFXFCrbPUoWgUogtUomrCrSbJwJwYqkL
xCrYrYMpeActDQalPONlZaCrENUovuUozFUoXxCrjcJwJwYqkL
rYrYDQDQDQctDQDQDQDQGfCrTlUoisUoZJUocqCrEjJwJwYqkL
rYXmLfLfLfgDDQDQDQDQDQCrNFUovPUoDmUoloCrGHJwJwJwkL
rYWlDQDQDQctDQDQDQDQDQUoUoUoUoTuWcWcFrCrgbJwJwJwkL
rYDQnyCZDQctDQDQDQDQDQUoHxUoUopNUoHxQRCrlOJwJwkVkL
rYDQadCZfLctUeDQVMDQDQaCaCaCUopNaCaCaCaCYfJwlpYxkL
rYDQWNCZDQctDQDQDQDQDQaCzLdFJmDbJmJmJmJwDPJwJwlEkL
rYDQDQDQDQLELfLfLfLfLfLULUVgLUcTLULUVaOYGCJwJwlLkL
rYWlDQDQDQctDQDQDQDQDQJmJmJmJmJmJmJmTTaCUZJwJwQIkL
rYdpDQDQDQctDQDQDQDQDQJmJmJmJmJmJmJmBNaCCHJwJwfskL
rYrYDQDQDQctDQDQDQDQDQaCuPJmjuHdJmJmVBaCrhJwJwYqkL
rYrYrYDQHCctDQHCDQDQDQaCqXJmhChCJmJmyNaCJOJwJwYqkL
FmXFXFXFXFexLMXFXFXFXFaCYEJmJmJmtDJmJmaCaHJwJwYqkL
FmFmmEkqfvqUNuWUiRXFFmaCbvFTkcsytcafcJaCxmJwJwYqkL
FmFmmELMLMexLMLMlfXFFmaCaCaCaCaCaCaCaCaCkLJwJwJwkL
FmFmmEWsLMqkLMIOcnXFFmFmFmFmFmFmFmFmFmFmkLIyJwJwkL
FmXFXFXFXFXFXFXFXFXFFmFmFmFmFmFmFmFmFmFmkLkLkLkLkL
"}
