//MAP CONVERTED BY dmm2tgm.py THIS HEADER COMMENT PREVENTS RECONVERSION, DO NOT REMOVE
"a" = (
/turf/template_noop,
/area/template_noop)
"j" = (
/obj/machinery/vending/security{
	pixel_x = 32
	},
/turf/open/floor/mineral/titanium/blue,
/area/ship/bridge)
"m" = (
/obj/machinery/power/smes/shuttle/precharged{
	dir = 4
	},
/obj/structure/window/reinforced/spawner/west,
/turf/open/floor/mineral/titanium/blue,
/area/ship/bridge)
"s" = (
/obj/machinery/computer/helm{
	dir = 8
	},
/obj/item/areaeditor/shuttle,
/turf/open/floor/mineral/titanium/blue,
/area/ship/bridge)
"t" = (
/turf/open/floor/mineral/titanium/blue,
/area/ship/bridge)
"u" = (
/obj/structure/cable/yellow{
	icon_state = "0-2"
	},
/obj/machinery/power/terminal{
	dir = 8
	},
/obj/machinery/computer/cryopod{
	pixel_y = 28
	},
/turf/open/floor/mineral/titanium/blue,
/area/ship/bridge)
"v" = (
/obj/structure/cable/yellow{
	icon_state = "0-4"
	},
/obj/machinery/power/terminal{
	dir = 8
	},
/obj/machinery/door/window/eastright{
	dir = 8
	},
/turf/open/floor/mineral/titanium/blue,
/area/ship/bridge)
"x" = (
/obj/structure/window/shuttle,
/obj/structure/grille,
/turf/open/floor/plating/airless,
/area/ship/bridge)
"y" = (
/obj/structure/cable/yellow{
	icon_state = "1-8"
	},
/obj/structure/cable/yellow{
	icon_state = "1-2"
	},
/obj/structure/cable/yellow{
	icon_state = "2-8"
	},
/turf/open/floor/mineral/titanium/blue,
/area/ship/bridge)
"F" = (
/obj/machinery/porta_turret/ai{
	on = 0
	},
/turf/closed/wall/mineral/titanium,
/area/ship/bridge)
"G" = (
/obj/machinery/power/shuttle/engine/electric{
	dir = 4
	},
/turf/open/floor/plating/airless,
/area/ship/external)
"I" = (
/obj/machinery/cryopod{
	alpha = 30
	},
/obj/item/radio/intercom/wideband{
	dir = 8;
	pixel_x = 24
	},
/turf/open/floor/mineral/titanium/blue,
/area/ship/bridge)
"L" = (
/obj/machinery/door/airlock/external,
/obj/structure/fans/tiny,
/obj/effect/mapping_helpers/airlock/cyclelink_helper,
/obj/docking_port/mobile{
	callTime = 50;
	dir = 2;
	dwidth = 4;
	height = 5;
	ignitionTime = 25;
	launch_status = 0;
	name = "NT Fighter";
	port_direction = 2;
	preferred_direction = 4;
	width = 9
	},
/turf/open/floor/plating/airless,
/area/ship/bridge)
"P" = (
/obj/machinery/door/airlock/external,
/obj/structure/fans/tiny,
/obj/effect/mapping_helpers/airlock/cyclelink_helper{
	dir = 1
	},
/turf/open/floor/plating/airless,
/area/ship/bridge)
"R" = (
/obj/machinery/power/smes/engineering,
/obj/structure/cable/yellow{
	icon_state = "0-2"
	},
/obj/structure/cable/yellow{
	icon_state = "1-2"
	},
/turf/open/floor/mineral/titanium/blue,
/area/ship/bridge)
"S" = (
/obj/structure/cable/yellow,
/obj/machinery/power/terminal{
	dir = 8
	},
/obj/machinery/autolathe,
/obj/structure/cable/yellow{
	icon_state = "1-4"
	},
/turf/open/floor/mineral/titanium/blue,
/area/ship/bridge)
"U" = (
/obj/structure/cable/yellow{
	icon_state = "1-2"
	},
/obj/structure/closet/wall/orange{
	dir = 4;
	name = "Survival Gear Locker";
	pixel_x = -31
	},
/obj/item/tank/internals/emergency_oxygen/double,
/obj/item/tank/internals/emergency_oxygen/double,
/obj/item/tank/internals/emergency_oxygen/double,
/obj/item/pickaxe,
/obj/item/pickaxe,
/obj/item/pickaxe,
/obj/item/mining_scanner,
/obj/item/mining_scanner,
/obj/item/mining_scanner,
/obj/item/stack/cable_coil/yellow,
/obj/item/storage/toolbox/mechanical,
/turf/open/floor/mineral/titanium/blue,
/area/ship/bridge)
"V" = (
/obj/machinery/holopad/emergency/command,
/turf/open/floor/mineral/titanium/blue,
/area/ship/bridge)
"W" = (
/turf/closed/wall/mineral/titanium,
/area/ship/bridge)
"X" = (
/obj/structure/cable/yellow{
	icon_state = "0-8"
	},
/obj/machinery/power/apc/auto_name/east{
	auto_name = 0;
	desc = "A control terminal for the ship's electrical systems.";
	name = "Nanotrasen Combat Frigate APC"
	},
/turf/open/floor/mineral/titanium/blue,
/area/ship/bridge)
"Y" = (
/obj/structure/cable{
	icon_state = "0-8"
	},
/obj/machinery/power/port_gen/pacman,
/obj/item/stack/sheet/mineral/plasma/twenty,
/obj/machinery/turretid{
	pixel_x = 26;
	req_access = list(1);
	req_access_txt = "1"
	},
/turf/open/floor/mineral/titanium/blue,
/area/ship/bridge)
"Z" = (
/obj/machinery/power/terminal{
	dir = 8
	},
/obj/structure/cable{
	icon_state = "0-4"
	},
/turf/open/floor/mineral/titanium/blue,
/area/ship/bridge)

(1,1,1) = {"
a
a
W
G
W
a
a
"}
(2,1,1) = {"
W
G
W
m
W
G
W
"}
(3,1,1) = {"
F
m
W
v
W
m
F
"}
(4,1,1) = {"
W
u
R
y
U
S
W
"}
(5,1,1) = {"
L
j
Z
V
t
X
P
"}
(6,1,1) = {"
W
t
Y
s
I
W
W
"}
(7,1,1) = {"
a
F
W
x
W
F
a
"}
