//MAP CONVERTED BY dmm2tgm.py THIS HEADER COMMENT PREVENTS RECONVERSION, DO NOT REMOVE
"aa" = (
/turf/closed/wall/mineral/bananium,
/area/ship/crew)
"ad" = (
/turf/closed/wall/mineral/bananium,
/area/ship/security)
"aU" = (
/obj/docking_port/mobile{
	dir = 2
	},
/turf/closed/wall/mineral/bananium,
/area/ship/bridge)
"cb" = (
/turf/closed/wall/mineral/bananium,
/area/ship/bridge)
"cf" = (
/obj/structure/table/wood/fancy/royalblue,
/obj/item/pneumatic_cannon/pie/selfcharge,
/obj/item/pneumatic_cannon/pie/selfcharge,
/obj/item/pneumatic_cannon/pie/selfcharge,
/obj/item/melee/transforming/energy/sword/saber/yellow,
/obj/item/melee/transforming/energy/sword/saber/yellow,
/obj/item/melee/transforming/energy/sword/saber/yellow,
/turf/open/floor/mineral/bananium,
/area/ship/security)
"cm" = (
/obj/structure/table/wood/fancy/royalblue,
/obj/item/nullrod/clown,
/obj/item/nullrod/clown,
/obj/item/nullrod/clown,
/obj/machinery/power/apc/auto_name/north,
/obj/machinery/power/terminal{
	dir = 1
	},
/obj/structure/cable{
	icon_state = "0-2"
	},
/obj/item/gun/magic/staff/honk,
/obj/machinery/light{
	dir = 1
	},
/turf/open/floor/mineral/bananium,
/area/ship/security)
"cx" = (
/obj/machinery/airalarm/all_access,
/turf/closed/wall/mineral/bananium,
/area/ship/security)
"cH" = (
/obj/machinery/airalarm/all_access,
/turf/closed/wall/mineral/bananium,
/area/ship/bridge)
"dg" = (
/obj/machinery/computer/helm,
/turf/open/floor/mineral/bananium,
/area/ship/bridge)
"dv" = (
/obj/machinery/computer/autopilot,
/obj/machinery/light{
	dir = 1
	},
/turf/open/floor/mineral/bananium,
/area/ship/bridge)
"ey" = (
/obj/structure/fans/tiny,
/obj/machinery/door/poddoor{
	id = "256ClowningMimes"
	},
/obj/item/grown/bananapeel/bluespace{
	alpha = 30
	},
/turf/open/floor/plating,
/area/ship/crew)
"eG" = (
/obj/machinery/airalarm/all_access{
	pixel_x = null;
	pixel_y = 24
	},
/obj/machinery/light{
	dir = 1
	},
/turf/open/floor/mineral/bananium,
/area/ship/crew)
"gK" = (
/obj/structure/window/plasma/reinforced{
	dir = 8
	},
/obj/machinery/atmospherics/components/unary/vent_scrubber/on/layer2,
/turf/open/floor/mineral/bananium,
/area/ship/security)
"hf" = (
/obj/item/areaeditor/shuttle,
/obj/structure/cable{
	icon_state = "1-2"
	},
/obj/machinery/atmospherics/components/unary/vent_pump/on/layer4,
/turf/open/floor/mineral/bananium,
/area/ship/security)
"hK" = (
/obj/structure/table/wood/fancy/royalblue,
/obj/item/bikehorn/golden,
/obj/item/clothing/head/clownmitre,
/obj/item/toy/crayon/spraycan/lubecan,
/obj/item/toy/crayon/spraycan/lubecan,
/obj/item/toy/crayon/spraycan/lubecan,
/obj/item/toy/crayon/spraycan/lubecan,
/turf/open/floor/mineral/bananium,
/area/ship/security)
"ic" = (
/obj/structure/window,
/obj/structure/window{
	dir = 1
	},
/obj/machinery/door/window{
	dir = 4
	},
/obj/structure/table/wood/fancy,
/obj/item/dnainjector/timed/h2m,
/obj/item/dnainjector/timed/h2m,
/obj/machinery/power/terminal{
	dir = 8
	},
/obj/machinery/power/apc/auto_name/west,
/turf/open/floor/mineral/bananium,
/area/ship/bridge)
"jf" = (
/obj/structure/cable{
	icon_state = "2-8"
	},
/obj/machinery/atmospherics/pipe/simple/supply/hidden/layer4{
	dir = 6
	},
/obj/structure/chair/comfy/shuttle,
/turf/open/floor/mineral/bananium,
/area/ship/bridge)
"ke" = (
/obj/structure/window/plasma/reinforced{
	dir = 4
	},
/obj/machinery/atmospherics/components/unary/vent_pump/on/layer4{
	dir = 8
	},
/obj/effect/decal/cleanable/glitter,
/obj/item/grown/bananapeel/bluespace{
	alpha = 30
	},
/turf/open/floor/mineral/bananium,
/area/ship/bridge)
"kJ" = (
/turf/open/floor/mineral/bananium,
/area/ship/crew)
"kT" = (
/obj/structure/fans/tiny,
/obj/machinery/door/poddoor{
	id = "246ClowningMimes"
	},
/obj/item/grown/bananapeel/bluespace{
	alpha = 30
	},
/turf/open/floor/plating,
/area/ship/crew)
"mz" = (
/obj/item/grown/bananapeel,
/turf/open/floor/mineral/bananium,
/area/ship/crew)
"nb" = (
/obj/structure/rack,
/obj/item/clothing/suit/space/hardsuit/clown,
/obj/item/storage/bag/ore,
/obj/item/clothing/shoes/clown_shoes/banana_shoes,
/obj/item/stack/sheet/mineral/bananium,
/obj/item/stack/sheet/mineral/bananium,
/obj/item/stack/sheet/mineral/bananium,
/obj/item/stack/sheet/mineral/bananium,
/obj/item/stack/sheet/mineral/bananium,
/obj/item/stack/sheet/mineral/bananium,
/obj/item/stack/sheet/mineral/bananium,
/obj/item/pickaxe/drill,
/obj/structure/window/plasma/reinforced,
/obj/structure/window/plasma/reinforced{
	dir = 8
	},
/obj/machinery/atmospherics/pipe/simple/scrubbers/hidden/layer2{
	dir = 5
	},
/turf/open/floor/mineral/bananium,
/area/ship/security)
"nl" = (
/obj/structure/cable{
	icon_state = "1-2"
	},
/obj/machinery/door/window/brigdoor/southright,
/obj/machinery/atmospherics/pipe/simple/scrubbers/hidden/layer2{
	dir = 10
	},
/obj/machinery/atmospherics/pipe/simple/supply/hidden/layer4,
/turf/open/floor/mineral/bananium,
/area/ship/security)
"nD" = (
/obj/structure/rack,
/obj/item/clothing/suit/space/hardsuit/clown,
/obj/item/storage/bag/ore,
/obj/item/clothing/shoes/clown_shoes/banana_shoes,
/obj/item/stack/sheet/mineral/bananium,
/obj/item/stack/sheet/mineral/bananium,
/obj/item/stack/sheet/mineral/bananium,
/obj/item/stack/sheet/mineral/bananium,
/obj/item/stack/sheet/mineral/bananium,
/obj/item/stack/sheet/mineral/bananium,
/obj/item/stack/sheet/mineral/bananium,
/obj/item/pickaxe/drill,
/obj/structure/window/plasma/reinforced,
/turf/open/floor/mineral/bananium,
/area/ship/security)
"om" = (
/obj/structure/grille,
/obj/effect/spawner/structure/window/reinforced,
/turf/open/floor/plating,
/area/ship/crew)
"oQ" = (
/obj/structure/grille,
/obj/structure/grille,
/obj/effect/spawner/structure/window/reinforced,
/turf/open/floor/plating,
/area/ship/crew)
"oS" = (
/obj/machinery/light{
	dir = 1
	},
/turf/open/floor/mineral/bananium,
/area/ship/crew)
"po" = (
/obj/item/clothing/suit/space/hardsuit/clown,
/obj/structure/rack,
/obj/item/storage/bag/ore,
/obj/item/clothing/shoes/clown_shoes/banana_shoes,
/obj/item/stack/sheet/mineral/bananium,
/obj/item/stack/sheet/mineral/bananium,
/obj/item/stack/sheet/mineral/bananium,
/obj/item/stack/sheet/mineral/bananium,
/obj/item/stack/sheet/mineral/bananium,
/obj/item/stack/sheet/mineral/bananium,
/obj/item/stack/sheet/mineral/bananium,
/obj/item/pickaxe/drill,
/obj/structure/window/plasma/reinforced,
/turf/open/floor/mineral/bananium,
/area/ship/bridge)
"pv" = (
/obj/structure/cable{
	icon_state = "1-2"
	},
/obj/machinery/door/window/brigdoor/southright,
/obj/machinery/atmospherics/pipe/simple/scrubbers/hidden/layer2{
	dir = 6
	},
/obj/machinery/atmospherics/pipe/simple/supply/hidden/layer4,
/obj/machinery/holopad/emergency/command,
/obj/item/grown/bananapeel,
/turf/open/floor/mineral/bananium,
/area/ship/bridge)
"qh" = (
/obj/structure/window/plasma/reinforced,
/obj/structure/window/plasma/reinforced{
	dir = 4
	},
/obj/machinery/atmospherics/components/unary/vent_scrubber/on/layer2{
	dir = 8
	},
/obj/item/bikehorn/rubberducky,
/obj/effect/decal/cleanable/glitter,
/turf/open/floor/mineral/bananium,
/area/ship/bridge)
"qr" = (
/obj/effect/decal/cleanable/glitter,
/turf/open/floor/mineral/bananium,
/area/ship/crew)
"rW" = (
/obj/structure/cable{
	icon_state = "1-2"
	},
/obj/machinery/atmospherics/pipe/simple/scrubbers/hidden/layer2,
/obj/machinery/atmospherics/pipe/simple/supply/hidden/layer4,
/turf/open/floor/mineral/bananium,
/area/ship/crew)
"rZ" = (
/obj/machinery/mineral/ore_redemption,
/obj/machinery/light{
	dir = 1
	},
/turf/open/floor/mineral/bananium,
/area/ship/crew)
"sj" = (
/obj/structure/fans/tiny,
/obj/structure/window/plasma/reinforced{
	dir = 1
	},
/obj/machinery/light{
	dir = 4
	},
/obj/machinery/button{
	id = "11HONKERSSHOOTITNOW!!!";
	name = "SHOOT THE SM!";
	pixel_x = 25
	},
/turf/open/floor/carpet/donk,
/area/ship/engineering/engine)
"sp" = (
/obj/machinery/autolathe,
/turf/open/floor/mineral/bananium,
/area/ship/crew)
"sQ" = (
/obj/machinery/ore_silo,
/turf/open/floor/mineral/bananium,
/area/ship/crew)
"tg" = (
/obj/structure/table/wood/fancy/royalblue,
/obj/machinery/microwave{
	pixel_y = 4
	},
/turf/open/floor/mineral/bananium,
/area/ship/crew)
"tD" = (
/obj/structure/table/wood/fancy/royalblue,
/obj/item/storage/box/donkpockets/donkpockethonk{
	pixel_y = 5
	},
/obj/item/storage/box/donkpockets/donkpockethonk{
	pixel_y = 5
	},
/obj/item/storage/box/donkpockets/donkpockethonk{
	pixel_y = 5
	},
/obj/item/storage/box/donkpockets/donkpockethonk{
	pixel_y = 5
	},
/obj/item/storage/box/donkpockets/donkpockethonk{
	pixel_y = 5
	},
/obj/item/storage/box/donkpockets/donkpockethonk{
	pixel_y = 5
	},
/obj/item/reagent_containers/food/snacks/grown/banana,
/obj/item/reagent_containers/food/snacks/grown/banana,
/obj/item/reagent_containers/food/snacks/grown/banana,
/turf/open/floor/mineral/bananium,
/area/ship/crew)
"tQ" = (
/obj/machinery/mecha_part_fabricator,
/obj/machinery/light{
	dir = 1
	},
/turf/open/floor/mineral/bananium,
/area/ship/crew)
"uo" = (
/obj/machinery/button/door{
	id = "256ClowningMimes";
	pixel_x = -9;
	pixel_y = 5
	},
/turf/closed/wall/mineral/bananium,
/area/ship/crew)
"ut" = (
/obj/effect/decal/cleanable/glitter,
/obj/machinery/button/door{
	id = "256ClowningMimes";
	pixel_y = -25;
	pixel_z = -5
	},
/turf/open/floor/mineral/bananium,
/area/ship/crew)
"uz" = (
/obj/effect/decal/cleanable/glitter,
/turf/open/floor/mineral/bananium,
/area/ship/crew/dorm)
"uN" = (
/obj/structure/cable{
	icon_state = "1-4"
	},
/obj/machinery/atmospherics/pipe/simple/scrubbers/hidden/layer2{
	dir = 5
	},
/obj/machinery/atmospherics/pipe/simple/supply/hidden/layer4{
	dir = 5
	},
/obj/item/bikehorn/rubberducky,
/turf/open/floor/mineral/bananium,
/area/ship/crew/dorm)
"uP" = (
/obj/structure/cable{
	icon_state = "4-8"
	},
/obj/machinery/atmospherics/pipe/manifold/scrubbers/hidden/layer2{
	dir = 1
	},
/obj/machinery/atmospherics/pipe/simple/supply/hidden/layer4{
	dir = 4
	},
/turf/open/floor/mineral/bananium,
/area/ship/crew/dorm)
"ve" = (
/obj/structure/cable{
	icon_state = "4-8"
	},
/obj/structure/cable{
	icon_state = "2-4"
	},
/obj/machinery/atmospherics/pipe/simple/scrubbers/hidden/layer2{
	dir = 4
	},
/obj/machinery/atmospherics/pipe/manifold/supply/hidden/layer4{
	dir = 1
	},
/turf/open/floor/mineral/bananium,
/area/ship/crew)
"vC" = (
/obj/structure/cable{
	icon_state = "4-8"
	},
/obj/item/stack/sheet/metal/fifty,
/obj/item/stack/sheet/metal/fifty,
/obj/item/stack/sheet/glass/fifty,
/obj/item/stack/sheet/mineral/bananium,
/obj/item/stack/sheet/mineral/bananium,
/obj/item/stack/sheet/mineral/bananium,
/obj/item/stack/sheet/mineral/bananium,
/obj/item/stack/sheet/mineral/bananium,
/obj/item/stack/sheet/mineral/bananium,
/obj/item/stack/sheet/mineral/bananium,
/obj/item/stack/sheet/mineral/bananium,
/obj/item/stack/sheet/mineral/bananium,
/obj/item/stack/sheet/mineral/bananium,
/obj/item/stack/sheet/mineral/bananium,
/obj/item/stack/sheet/mineral/bananium,
/obj/item/stack/sheet/mineral/bananium,
/obj/item/stack/sheet/mineral/bananium,
/obj/item/stack/sheet/mineral/bananium,
/obj/item/stack/sheet/mineral/bananium,
/obj/item/stack/sheet/mineral/bananium,
/obj/item/stack/sheet/mineral/bananium,
/obj/item/stack/sheet/mineral/bananium,
/obj/item/stack/sheet/mineral/bananium,
/obj/machinery/atmospherics/pipe/simple/scrubbers/hidden/layer2{
	dir = 4
	},
/obj/machinery/atmospherics/pipe/simple/supply/hidden/layer4{
	dir = 4
	},
/turf/open/floor/mineral/bananium,
/area/ship/crew)
"vQ" = (
/obj/structure/cable{
	icon_state = "4-8"
	},
/obj/machinery/atmospherics/pipe/simple/scrubbers/hidden/layer2{
	dir = 4
	},
/obj/machinery/atmospherics/pipe/simple/supply/hidden/layer4{
	dir = 4
	},
/turf/open/floor/mineral/bananium,
/area/ship/crew)
"vR" = (
/obj/structure/cable{
	icon_state = "4-8"
	},
/obj/structure/cable{
	icon_state = "2-4"
	},
/obj/machinery/atmospherics/pipe/simple/scrubbers/hidden/layer2{
	dir = 4
	},
/obj/machinery/atmospherics/pipe/simple/supply/hidden/layer4{
	dir = 4
	},
/turf/open/floor/mineral/bananium,
/area/ship/crew)
"wd" = (
/obj/structure/cable{
	icon_state = "4-8"
	},
/obj/structure/cable{
	icon_state = "2-8"
	},
/obj/machinery/atmospherics/pipe/simple/scrubbers/hidden/layer2{
	dir = 4
	},
/obj/machinery/atmospherics/pipe/simple/supply/hidden/layer4{
	dir = 4
	},
/turf/open/floor/mineral/bananium,
/area/ship/crew)
"wu" = (
/obj/structure/cable{
	icon_state = "1-8"
	},
/obj/machinery/atmospherics/pipe/simple/scrubbers/hidden/layer2{
	dir = 9
	},
/obj/machinery/atmospherics/pipe/simple/supply/hidden/layer4{
	dir = 9
	},
/turf/open/floor/mineral/bananium,
/area/ship/crew)
"wB" = (
/obj/structure/tank_dispenser/oxygen,
/obj/machinery/light,
/turf/open/floor/mineral/bananium,
/area/ship/crew)
"wP" = (
/obj/item/grown/bananapeel,
/obj/machinery/button/door{
	id = "246ClowningMimes";
	pixel_y = -25
	},
/turf/open/floor/mineral/bananium,
/area/ship/crew)
"wS" = (
/obj/effect/decal/cleanable/glitter,
/obj/machinery/jukebox/disco,
/turf/open/floor/mineral/bananium,
/area/ship/crew)
"xb" = (
/obj/machinery/button/door{
	id = "246ClowningMimes";
	pixel_x = 9;
	pixel_y = 5
	},
/turf/closed/wall/mineral/bananium,
/area/ship/crew)
"xy" = (
/obj/machinery/computer/cryopod,
/turf/closed/wall/mineral/bananium,
/area/ship/crew/dorm)
"zb" = (
/obj/machinery/cryopod{
	dir = 1
	},
/obj/machinery/light,
/turf/open/floor/mineral/bananium,
/area/ship/crew/dorm)
"zk" = (
/obj/machinery/atmospherics/pipe/manifold/scrubbers/hidden/layer2{
	dir = 8
	},
/obj/machinery/atmospherics/pipe/simple/supply/hidden/layer4{
	dir = 6
	},
/obj/item/grown/bananapeel,
/turf/open/floor/mineral/bananium,
/area/ship/crew/dorm)
"Ar" = (
/obj/structure/cable{
	icon_state = "1-2"
	},
/obj/machinery/atmospherics/components/unary/vent_scrubber/on/layer2{
	dir = 8
	},
/obj/machinery/atmospherics/pipe/manifold/supply/hidden/layer4,
/turf/open/floor/mineral/bananium,
/area/ship/crew)
"As" = (
/obj/machinery/atmospherics/components/unary/vent_pump/on/layer4{
	dir = 8
	},
/obj/effect/decal/cleanable/glitter,
/turf/open/floor/mineral/bananium,
/area/ship/crew)
"AX" = (
/obj/structure/cable{
	icon_state = "1-2"
	},
/turf/open/floor/mineral/bananium,
/area/ship/crew)
"BU" = (
/obj/structure/cable,
/obj/machinery/power/port_gen/pacman,
/obj/item/stack/sheet/mineral/plasma/twenty,
/turf/open/floor/mineral/bananium,
/area/ship/crew)
"BZ" = (
/obj/machinery/vending/autodrobe/all_access,
/turf/open/floor/mineral/bananium,
/area/ship/crew)
"Ca" = (
/obj/machinery/power/apc/auto_name/west,
/obj/machinery/power/terminal{
	dir = 8
	},
/obj/structure/cable{
	icon_state = "0-4"
	},
/obj/machinery/atmospherics/pipe/simple/scrubbers/hidden/layer2{
	dir = 5
	},
/obj/machinery/atmospherics/pipe/simple/supply/hidden/layer4{
	dir = 5
	},
/turf/open/floor/mineral/bananium,
/area/ship/crew)
"Cu" = (
/obj/structure/cable{
	icon_state = "1-8"
	},
/obj/machinery/atmospherics/pipe/simple/scrubbers/hidden/layer2{
	dir = 10
	},
/obj/machinery/atmospherics/pipe/simple/supply/hidden/layer4{
	dir = 10
	},
/obj/effect/decal/cleanable/glitter,
/turf/open/floor/mineral/bananium,
/area/ship/crew)
"Ef" = (
/obj/item/bikehorn/rubberducky,
/obj/effect/decal/cleanable/glitter,
/turf/open/floor/mineral/bananium,
/area/ship/crew)
"Es" = (
/obj/structure/cable{
	icon_state = "1-2"
	},
/obj/item/grown/bananapeel,
/obj/structure/window/plasma/reinforced{
	dir = 8
	},
/obj/structure/window/plasma/reinforced{
	dir = 1
	},
/turf/open/floor/carpet/donk,
/area/ship/engineering/engine)
"Fa" = (
/obj/structure/fans/tiny,
/obj/structure/window/plasma/reinforced{
	dir = 1
	},
/turf/open/floor/carpet/donk,
/area/ship/engineering/engine)
"Gh" = (
/turf/closed/wall/mineral/bananium,
/area/ship/engineering/engine)
"GM" = (
/obj/structure/tank_dispenser/plasma,
/obj/structure/window/plasma/reinforced{
	dir = 1
	},
/turf/open/floor/mineral/bananium,
/area/ship/engineering/engine)
"HY" = (
/obj/machinery/door/window/brigdoor/southright{
	dir = 1
	},
/obj/machinery/atmospherics/pipe/simple/scrubbers/hidden/layer2,
/obj/machinery/atmospherics/pipe/simple/supply/hidden/layer4,
/turf/open/floor/mineral/bananium,
/area/ship/engineering/engine)
"Ie" = (
/obj/machinery/atmospherics/components/unary/tank/air,
/obj/structure/window/plasma/reinforced{
	dir = 1
	},
/turf/open/floor/mineral/bananium,
/area/ship/engineering/engine)
"In" = (
/obj/machinery/atmospherics/components/unary/thermomachine/freezer/on,
/obj/structure/window/plasma/reinforced{
	dir = 1
	},
/turf/open/floor/carpet/donk,
/area/ship/engineering/engine)
"Iu" = (
/obj/structure/cable{
	icon_state = "1-2"
	},
/obj/structure/cable{
	icon_state = "1-4"
	},
/turf/open/floor/carpet/donk,
/area/ship/engineering/engine)
"Iy" = (
/obj/machinery/power/rad_collector/anchored,
/obj/structure/fans/tiny,
/obj/structure/cable{
	icon_state = "0-8"
	},
/turf/open/floor/carpet/donk,
/area/ship/engineering/engine)
"Jj" = (
/obj/machinery/atmospherics/components/unary/vent_pump{
	dir = 1
	},
/obj/structure/railing{
	dir = 8
	},
/obj/structure/railing{
	dir = 1
	},
/turf/open/floor/mineral/titanium/yellow,
/area/ship/engineering/engine)
"Jw" = (
/obj/machinery/atmospherics/components/unary/vent_pump{
	dir = 1
	},
/obj/structure/railing{
	dir = 1
	},
/turf/open/floor/mineral/titanium/yellow,
/area/ship/engineering/engine)
"KW" = (
/obj/structure/closet,
/obj/item/reagent_containers/food/snacks/pie/cream,
/obj/item/reagent_containers/food/snacks/pie/cream,
/obj/item/reagent_containers/food/snacks/pie/cream,
/obj/item/reagent_containers/food/snacks/pie/cream,
/obj/item/reagent_containers/food/snacks/pie/cream,
/obj/item/reagent_containers/food/snacks/pie/cream,
/obj/item/reagent_containers/food/snacks/pie/cream,
/obj/item/reagent_containers/food/snacks/pie/cream,
/obj/item/reagent_containers/food/snacks/pie/cream,
/obj/item/reagent_containers/food/snacks/pie/cream,
/obj/item/reagent_containers/food/snacks/pie/cream,
/obj/item/reagent_containers/food/snacks/pie/cream,
/obj/item/reagent_containers/food/snacks/pie/cream,
/obj/item/reagent_containers/food/snacks/pie/cream,
/obj/item/reagent_containers/food/snacks/pie/cream,
/obj/item/reagent_containers/food/snacks/pie/cream,
/obj/item/reagent_containers/food/snacks/pie/cream,
/obj/item/reagent_containers/food/snacks/pie/cream,
/obj/item/reagent_containers/food/snacks/pie/cream,
/obj/item/reagent_containers/food/snacks/pie/cream,
/obj/item/reagent_containers/food/snacks/pie/cream,
/obj/item/reagent_containers/food/snacks/pie/cream,
/obj/item/reagent_containers/food/snacks/pie/cream,
/obj/item/reagent_containers/food/snacks/pie/cream,
/obj/item/reagent_containers/food/snacks/pie/cream,
/obj/item/reagent_containers/food/snacks/pie/cream,
/obj/item/reagent_containers/food/snacks/pie/cream,
/obj/item/reagent_containers/food/snacks/pie/cream,
/obj/item/reagent_containers/food/snacks/pie/cream,
/obj/item/reagent_containers/food/snacks/pie/cream,
/obj/item/reagent_containers/food/snacks/pie/cream,
/obj/item/reagent_containers/food/snacks/pie/cream,
/obj/item/reagent_containers/food/snacks/pie/cream,
/obj/item/reagent_containers/food/snacks/pie/cream,
/obj/item/reagent_containers/food/snacks/pie/cream,
/obj/item/reagent_containers/food/snacks/pie/cream,
/obj/item/reagent_containers/food/snacks/pie/cream,
/obj/item/reagent_containers/food/snacks/pie/cream,
/obj/item/reagent_containers/food/snacks/pie/cream,
/obj/item/reagent_containers/food/snacks/pie/cream,
/obj/item/reagent_containers/food/snacks/pie/cream,
/obj/machinery/light{
	dir = 8
	},
/turf/open/floor/mineral/bananium,
/area/ship/engineering/engine)
"Lg" = (
/obj/machinery/atmospherics/pipe/simple/scrubbers/hidden/layer2,
/obj/machinery/atmospherics/pipe/simple/supply/hidden/layer4,
/turf/open/floor/mineral/bananium,
/area/ship/engineering/engine)
"Lr" = (
/obj/machinery/atmospherics/pipe/layer_manifold,
/turf/open/floor/mineral/bananium,
/area/ship/engineering/engine)
"LQ" = (
/obj/machinery/atmospherics/components/unary/thermomachine/freezer/on,
/turf/open/floor/carpet/donk,
/area/ship/engineering/engine)
"LW" = (
/obj/structure/cable{
	icon_state = "1-2"
	},
/obj/structure/cable{
	icon_state = "1-4"
	},
/obj/item/pipe_dispenser,
/turf/open/floor/carpet/donk,
/area/ship/engineering/engine)
"Mj" = (
/obj/machinery/power/emitter,
/obj/structure/cable{
	icon_state = "0-8"
	},
/obj/structure/fans/tiny,
/turf/open/floor/carpet/donk,
/area/ship/engineering/engine)
"Ml" = (
/obj/structure/railing{
	dir = 8
	},
/turf/open/floor/mineral/titanium/yellow,
/area/ship/engineering/engine)
"Mn" = (
/obj/machinery/mass_driver{
	dir = 4;
	id = "11HONKERSSHOOTITNOW!!!"
	},
/obj/machinery/power/supermatter_crystal/shard,
/turf/open/floor/mineral/titanium/yellow,
/area/ship/engineering/engine)
"MA" = (
/obj/machinery/door/poddoor{
	id = "11HONKERSSHOOTITNOW!!!"
	},
/turf/open/floor/mineral/bananium,
/area/ship/engineering/engine)
"Ny" = (
/obj/machinery/portable_atmospherics/canister/nitrogen,
/obj/effect/decal/cleanable/glitter,
/turf/open/floor/mineral/bananium,
/area/ship/engineering/engine)
"NA" = (
/mob/living/simple_animal/pet/penguin/emperor/shamebrero{
	desc = "Weakest Clown Player.";
	icon = 'icons/mob/clown_mobs.dmi';
	icon_living = "chlown";
	icon_state = "chlown";
	name = "Chlowne"
	},
/obj/machinery/atmospherics/pipe/simple/scrubbers/hidden/layer2,
/obj/machinery/atmospherics/pipe/simple/supply/hidden/layer4{
	dir = 5
	},
/obj/effect/decal/cleanable/glitter,
/turf/open/floor/mineral/bananium,
/area/ship/engineering/engine)
"Oi" = (
/obj/machinery/atmospherics/pipe/simple/supply/hidden/layer4{
	dir = 9
	},
/turf/open/floor/mineral/bananium,
/area/ship/engineering/engine)
"Pe" = (
/obj/structure/cable{
	icon_state = "1-4"
	},
/obj/structure/cable{
	icon_state = "1-2"
	},
/obj/item/bikehorn/rubberducky,
/obj/effect/decal/cleanable/glitter,
/turf/open/floor/carpet/donk,
/area/ship/engineering/engine)
"Py" = (
/obj/machinery/atmospherics/components/unary/vent_scrubber/on,
/obj/structure/railing{
	dir = 8
	},
/obj/structure/railing,
/turf/open/floor/mineral/titanium/yellow,
/area/ship/engineering/engine)
"PJ" = (
/obj/machinery/atmospherics/components/unary/vent_scrubber/on,
/obj/structure/railing,
/turf/open/floor/mineral/titanium/yellow,
/area/ship/engineering/engine)
"PP" = (
/obj/machinery/portable_atmospherics/canister/nitrogen,
/obj/machinery/light,
/obj/machinery/light{
	dir = 8
	},
/turf/open/floor/mineral/bananium,
/area/ship/engineering/engine)
"Qb" = (
/obj/machinery/atmospherics/pipe/simple/scrubbers/hidden/layer2{
	dir = 5
	},
/obj/effect/decal/cleanable/glitter,
/turf/open/floor/mineral/bananium,
/area/ship/engineering/engine)
"Qc" = (
/obj/machinery/atmospherics/pipe/simple/scrubbers/hidden/layer2{
	dir = 4
	},
/turf/open/floor/mineral/bananium,
/area/ship/engineering/engine)
"Qi" = (
/obj/machinery/atmospherics/pipe/simple/scrubbers/hidden/layer2{
	dir = 4
	},
/turf/open/floor/carpet/donk,
/area/ship/engineering/engine)
"QH" = (
/obj/structure/cable{
	icon_state = "1-4"
	},
/obj/structure/cable{
	icon_state = "1-2"
	},
/obj/machinery/atmospherics/pipe/simple/scrubbers/hidden/layer2{
	dir = 10
	},
/obj/effect/decal/cleanable/glitter,
/turf/open/floor/carpet/donk,
/area/ship/engineering/engine)
"Ss" = (
/obj/structure/fans/tiny,
/obj/structure/cable{
	icon_state = "4-8"
	},
/obj/effect/decal/cleanable/glitter,
/turf/open/floor/carpet/donk,
/area/ship/engineering/engine)
"SL" = (
/obj/structure/fans/tiny,
/obj/structure/cable{
	icon_state = "4-8"
	},
/turf/open/floor/carpet/donk,
/area/ship/engineering/engine)
"Tw" = (
/obj/structure/fans/tiny,
/obj/machinery/power/apc/auto_name/south,
/obj/machinery/power/terminal,
/obj/structure/cable{
	icon_state = "0-8"
	},
/obj/machinery/light,
/obj/machinery/light{
	dir = 4
	},
/turf/open/floor/carpet/donk,
/area/ship/engineering/engine)
"UA" = (
/obj/machinery/power/terminal,
/obj/structure/cable{
	icon_state = "0-4"
	},
/turf/open/floor/mineral/bananium,
/area/ship/engineering/engine)
"UM" = (
/obj/structure/cable{
	icon_state = "4-8"
	},
/obj/structure/table/wood/fancy/royalblue,
/obj/item/storage/toolbox/mechanical,
/turf/open/floor/mineral/bananium,
/area/ship/engineering/engine)
"UN" = (
/obj/structure/cable{
	icon_state = "4-8"
	},
/obj/structure/table/wood/fancy/royalblue,
/obj/item/fugu_gland,
/turf/open/floor/carpet/donk,
/area/ship/engineering/engine)
"Vk" = (
/obj/structure/cable{
	icon_state = "1-8"
	},
/obj/machinery/deepfryer,
/obj/machinery/atmospherics/pipe/simple/scrubbers/hidden/layer2,
/turf/open/floor/carpet/donk,
/area/ship/engineering/engine)
"VV" = (
/obj/machinery/airalarm/all_access{
	dir = 1;
	pixel_y = -24
	},
/turf/open/floor/carpet/donk,
/area/ship/engineering/engine)
"VZ" = (
/turf/open/floor/carpet/donk,
/area/ship/engineering/engine)
"WK" = (
/obj/machinery/power/smes/shuttle/precharged{
	dir = 1
	},
/obj/structure/window/plasma/reinforced,
/obj/structure/cable{
	icon_state = "0-2"
	},
/turf/open/floor/plating,
/area/ship/engineering/engine)
"XI" = (
/turf/template_noop,
/area/template_noop)
"XJ" = (
/obj/machinery/atmospherics/pipe/simple/scrubbers/hidden/layer2{
	dir = 5
	},
/turf/closed/wall/mineral/bananium,
/area/ship/engineering/engine)
"XW" = (
/obj/machinery/atmospherics/pipe/simple/scrubbers/hidden/layer2{
	dir = 4
	},
/turf/closed/wall/mineral/bananium,
/area/ship/engineering/engine)
"Yo" = (
/obj/structure/grille,
/obj/effect/spawner/structure/window/reinforced,
/obj/machinery/atmospherics/pipe/simple/yellow,
/turf/open/floor/plating,
/area/ship/engineering/engine)
"ZO" = (
/obj/machinery/power/shuttle/engine/electric{
	dir = 1
	},
/obj/structure/cable,
/turf/open/floor/plating,
/area/ship/engineering/engine)
"ZP" = (
/obj/machinery/atmospherics/components/unary/outlet_injector/atmos/air_input{
	dir = 1
	},
/turf/open/floor/plating,
/area/ship/engineering/engine)

(1,1,1) = {"
XI
aa
ey
kT
kT
uo
XI
XI
XI
XI
XI
XI
XI
XI
XI
"}
(2,1,1) = {"
aa
aa
eG
mz
ut
aa
aa
XI
XI
XI
XI
XI
XI
XI
XI
"}
(3,1,1) = {"
ad
cf
gK
nb
qr
uz
xy
aa
XI
XI
XI
XI
XI
XI
XI
"}
(4,1,1) = {"
ad
cm
hf
nl
rW
uN
zb
aa
aa
aa
aa
aa
aa
XI
XI
"}
(5,1,1) = {"
ad
cx
hK
nD
kJ
uP
zk
Ca
GM
KW
Ny
PP
Gh
Gh
XI
"}
(6,1,1) = {"
XI
ad
ad
ad
rZ
ve
Ar
Cu
HY
Lg
NA
Qb
UA
WK
ZO
"}
(7,1,1) = {"
XI
XI
XI
om
sp
vC
As
Ef
Ie
Lr
Oi
Qc
UM
Gh
XI
"}
(8,1,1) = {"
XI
XI
XI
oQ
sQ
vQ
qr
wS
In
LQ
LQ
Qi
UN
Gh
XI
"}
(9,1,1) = {"
XI
XI
XI
om
tg
vR
AX
Es
Iu
LW
Pe
QH
Vk
XJ
XI
"}
(10,1,1) = {"
XI
XI
XI
om
tD
vQ
kJ
Fa
Iy
Mj
Iy
Ss
VV
XW
XI
"}
(11,1,1) = {"
XI
cb
cb
cb
tQ
vQ
kJ
Fa
Jj
Ml
Py
SL
VZ
Yo
ZP
"}
(12,1,1) = {"
aU
cH
ic
po
kJ
wd
BU
sj
Jw
Mn
PJ
Tw
Gh
Gh
XI
"}
(13,1,1) = {"
cb
dg
jf
pv
rW
wu
BZ
Gh
Gh
MA
Gh
Gh
Gh
XI
XI
"}
(14,1,1) = {"
cb
dv
ke
qh
kJ
wB
aa
aa
XI
XI
XI
XI
XI
XI
XI
"}
(15,1,1) = {"
aa
aa
oS
kJ
wP
aa
aa
XI
XI
XI
XI
XI
XI
XI
XI
"}
(16,1,1) = {"
XI
aa
kT
kT
kT
xb
XI
XI
XI
XI
XI
XI
XI
XI
XI
"}
