//MAP CONVERTED BY dmm2tgm.py THIS HEADER COMMENT PREVENTS RECONVERSION, DO NOT REMOVE
"a" = (
/turf/template_noop,
/area/template_noop)
"f" = (
/obj/structure/window/shuttle,
/obj/structure/grille,
/turf/open/floor/plating,
/area/ship/bridge)
"h" = (
/obj/machinery/computer/helm,
/turf/open/floor/carpet/executive,
/area/ship/bridge)
"i" = (
/obj/machinery/computer/monitor,
/turf/open/floor/carpet/executive,
/area/ship/bridge)
"j" = (
/turf/open/floor/carpet/executive,
/area/ship/bridge)
"k" = (
/obj/machinery/computer/autopilot,
/turf/open/floor/carpet/executive,
/area/ship/bridge)
"l" = (
/turf/closed/wall/mineral/titanium/nodiagonal,
/area/ship/bridge)
"n" = (
/obj/machinery/light{
	dir = 1
	},
/obj/structure/closet/wall/red{
	dir = 4;
	pixel_x = -32
	},
/obj/item/mining_scanner,
/obj/item/mining_scanner,
/obj/item/mining_scanner,
/obj/item/resonator,
/obj/item/resonator,
/obj/item/resonator,
/obj/item/storage/bag/ore,
/obj/item/storage/bag/ore,
/obj/item/storage/bag/ore,
/obj/item/tank/internals/emergency_oxygen/double,
/obj/item/tank/internals/emergency_oxygen/double,
/obj/item/tank/internals/emergency_oxygen/double,
/turf/open/floor/carpet/executive,
/area/ship/bridge)
"r" = (
/obj/item/areaeditor/shuttle,
/obj/machinery/recharger{
	pixel_x = 11;
	pixel_y = 10
	},
/turf/open/floor/carpet/executive,
/area/ship/bridge)
"s" = (
/obj/machinery/holopad/emergency/command,
/turf/open/floor/carpet/executive,
/area/ship/bridge)
"u" = (
/obj/machinery/vending/security/marine/solgov,
/obj/machinery/light{
	dir = 1
	},
/obj/structure/sign/poster/official/random{
	pixel_x = 32
	},
/turf/open/floor/carpet/executive,
/area/ship/bridge)
"v" = (
/obj/machinery/door/airlock/shuttle/glass,
/obj/structure/fans/tiny,
/turf/open/floor/carpet/executive,
/area/ship/bridge)
"w" = (
/obj/machinery/door/airlock/shuttle/glass,
/obj/structure/fans/tiny,
/obj/docking_port/mobile{
	can_move_docking_ports = 1;
	dir = 4;
	name = "Nanopill";
	port_direction = 8
	},
/turf/open/floor/carpet/executive,
/area/ship/bridge)
"x" = (
/obj/machinery/computer/cryopod{
	pixel_x = -32
	},
/obj/machinery/cryopod{
	dir = 4
	},
/turf/open/floor/plasteel{
	icon_state = "steel"
	},
/area/ship/bridge)
"z" = (
/obj/machinery/mineral/ore_redemption{
	dir = 8
	},
/obj/structure/fans/tiny,
/obj/machinery/door/window{
	dir = 4
	},
/obj/machinery/door/window{
	dir = 8
	},
/turf/open/floor/plasteel{
	icon_state = "steel"
	},
/area/ship/bridge)
"B" = (
/obj/machinery/suit_storage_unit/ert/security,
/obj/effect/turf_decal/box/white,
/obj/machinery/light{
	dir = 8
	},
/obj/structure/sign/poster/official/random{
	pixel_x = -32
	},
/turf/open/floor/plasteel{
	icon_state = "steel"
	},
/area/ship/bridge)
"C" = (
/obj/machinery/power/apc/auto_name/east,
/obj/structure/cable{
	icon_state = "0-2"
	},
/obj/machinery/power/terminal{
	dir = 4
	},
/obj/machinery/light{
	dir = 4
	},
/obj/item/reagent_containers/glass/bucket,
/obj/item/mop,
/obj/structure/reagent_dispensers/watertank,
/turf/open/floor/carpet/executive,
/area/ship/bridge)
"D" = (
/obj/machinery/suit_storage_unit/ert/security,
/obj/effect/turf_decal/box/white,
/turf/open/floor/plasteel{
	icon_state = "steel"
	},
/area/ship/bridge)
"F" = (
/obj/structure/cable{
	icon_state = "2-4"
	},
/turf/open/floor/carpet/executive,
/area/ship/bridge)
"G" = (
/obj/structure/cable{
	icon_state = "4-8"
	},
/turf/open/floor/carpet/executive,
/area/ship/bridge)
"J" = (
/obj/structure/cable{
	icon_state = "2-8"
	},
/obj/machinery/autolathe,
/obj/structure/cable{
	icon_state = "1-2"
	},
/turf/open/floor/plasteel{
	icon_state = "steel"
	},
/area/ship/bridge)
"K" = (
/obj/structure/sign/nanotrasen,
/turf/closed/wall/mineral/titanium/nodiagonal,
/area/ship/bridge)
"M" = (
/obj/structure/cable{
	icon_state = "1-2"
	},
/turf/open/floor/carpet/executive,
/area/ship/bridge)
"N" = (
/obj/machinery/power/terminal{
	dir = 4
	},
/obj/structure/cable/yellow{
	icon_state = "0-2"
	},
/turf/open/floor/carpet/executive,
/area/ship/bridge)
"O" = (
/obj/machinery/power/smes/engineering,
/obj/structure/cable,
/turf/open/floor/plasteel{
	icon_state = "steel"
	},
/area/ship/bridge)
"P" = (
/obj/structure/closet/crate/engineering,
/obj/item/stack/sheet/mineral/plasma/fifty,
/obj/item/stack/sheet/mineral/plasma/fifty,
/obj/item/storage/toolbox/mechanical,
/obj/machinery/light,
/obj/structure/sign/poster/official/random{
	pixel_x = -32
	},
/obj/item/pipe_dispenser,
/turf/open/floor/carpet/executive,
/area/ship/bridge)
"S" = (
/obj/machinery/power/terminal,
/obj/structure/cable,
/turf/open/floor/carpet/executive,
/area/ship/bridge)
"W" = (
/obj/machinery/power/port_gen/pacman,
/obj/structure/cable/yellow,
/obj/machinery/light,
/turf/open/floor/carpet/executive,
/area/ship/bridge)
"X" = (
/obj/machinery/power/smes/shuttle/precharged{
	dir = 1
	},
/obj/structure/window/reinforced,
/obj/structure/cable/yellow{
	icon_state = "0-2"
	},
/turf/open/floor/carpet/executive,
/area/ship/bridge)
"Y" = (
/obj/machinery/power/shuttle/engine/electric{
	dir = 1
	},
/obj/structure/cable/yellow,
/turf/open/floor/plating,
/area/ship/bridge)

(1,1,1) = {"
a
a
f
l
v
l
l
f
K
l
a
a
"}
(2,1,1) = {"
a
f
f
n
j
x
B
D
D
l
l
a
"}
(3,1,1) = {"
f
f
i
j
j
j
j
j
j
P
l
l
"}
(4,1,1) = {"
f
h
r
s
j
j
j
F
M
S
X
Y
"}
(5,1,1) = {"
f
f
k
j
j
j
j
G
N
W
l
l
"}
(6,1,1) = {"
a
f
f
u
j
j
C
J
O
l
l
a
"}
(7,1,1) = {"
a
a
f
l
w
z
l
f
K
l
a
a
"}
