//MAP CONVERTED BY dmm2tgm.py THIS HEADER COMMENT PREVENTS RECONVERSION, DO NOT REMOVE
"a" = (
/turf/open/space/basic,
/area/space)
"f" = (
/obj/structure/cable{
	icon_state = "2-4"
	},
/turf/open/floor/carpet/executive,
/area/space)
"h" = (
/obj/structure/closet/wall/red{
	dir = 8;
	pixel_x = -32
	},
/obj/machinery/light{
	dir = 1
	},
/obj/item/tank/internals/emergency_oxygen/double/empty,
/obj/item/tank/internals/emergency_oxygen/double/empty,
/obj/item/tank/internals/emergency_oxygen/double/empty,
/obj/item/mining_scanner,
/obj/item/mining_scanner,
/obj/item/mining_scanner,
/obj/item/resonator,
/obj/item/resonator,
/obj/item/resonator,
/turf/open/floor/carpet/executive,
/area/space)
"i" = (
/obj/structure/cable{
	icon_state = "2-8"
	},
/obj/machinery/autolathe,
/obj/structure/cable{
	icon_state = "1-2"
	},
/turf/open/floor/plasteel{
	icon_state = "steel"
	},
/area/space)
"j" = (
/obj/structure/cable{
	icon_state = "4-8"
	},
/turf/open/floor/carpet/executive,
/area/space)
"k" = (
/obj/machinery/power/apc/auto_name/east,
/obj/structure/cable{
	icon_state = "0-2"
	},
/obj/machinery/power/terminal{
	dir = 4
	},
/obj/machinery/light{
	dir = 4
	},
/obj/item/reagent_containers/glass/bucket,
/obj/item/mop,
/turf/open/floor/carpet/executive,
/area/space)
"l" = (
/obj/structure/window/shuttle,
/obj/structure/grille,
/turf/open/floor/plating,
/area/space)
"n" = (
/obj/machinery/door/airlock/shuttle/glass,
/obj/structure/fans/tiny,
/turf/open/floor/carpet/executive,
/area/space)
"s" = (
/obj/machinery/computer/autopilot,
/turf/open/floor/carpet/executive,
/area/space)
"u" = (
/obj/machinery/power/smes/shuttle/precharged{
	dir = 1
	},
/obj/structure/window/reinforced,
/obj/structure/cable/yellow{
	icon_state = "0-2"
	},
/turf/open/floor/carpet/executive,
/area/space)
"v" = (
/turf/closed/wall/mineral/titanium/nodiagonal,
/area/space)
"w" = (
/obj/structure/sign/nanotrasen,
/turf/closed/wall/mineral/titanium/nodiagonal,
/area/space)
"x" = (
/turf/open/floor/carpet/executive,
/area/space)
"z" = (
/obj/machinery/holopad/emergency/command,
/turf/open/floor/carpet/executive,
/area/space)
"B" = (
/obj/machinery/computer/helm,
/turf/open/floor/carpet/executive,
/area/space)
"C" = (
/obj/machinery/suit_storage_unit/ert/security,
/obj/effect/turf_decal/box/white,
/turf/open/floor/plasteel{
	icon_state = "steel"
	},
/area/space)
"D" = (
/obj/machinery/door/airlock/shuttle/glass,
/obj/structure/fans/tiny,
/obj/docking_port/mobile{
	can_move_docking_ports = 1;
	dir = 4;
	name = "Nanopill";
	port_direction = 8
	},
/turf/open/floor/carpet/executive,
/area/space)
"F" = (
/obj/structure/sign/poster/official/random{
	pixel_x = 32
	},
/obj/structure/reagent_dispensers/watertank,
/turf/open/floor/carpet/executive,
/area/space)
"G" = (
/obj/machinery/suit_storage_unit/ert/security,
/obj/effect/turf_decal/box/white,
/obj/machinery/light{
	dir = 8
	},
/turf/open/floor/plasteel{
	icon_state = "steel"
	},
/area/space)
"J" = (
/obj/machinery/power/port_gen/pacman,
/obj/structure/cable/yellow,
/obj/machinery/light,
/turf/open/floor/carpet/executive,
/area/space)
"K" = (
/obj/machinery/power/terminal{
	dir = 4
	},
/obj/structure/cable/yellow{
	icon_state = "0-2"
	},
/turf/open/floor/carpet/executive,
/area/space)
"M" = (
/obj/machinery/cryopod{
	alpha = 30;
	dir = 1
	},
/obj/machinery/computer/cryopod{
	pixel_x = -32
	},
/turf/open/floor/plasteel{
	icon_state = "steel"
	},
/area/space)
"N" = (
/obj/structure/cable{
	icon_state = "1-2"
	},
/turf/open/floor/carpet/executive,
/area/space)
"O" = (
/obj/structure/closet/crate/engineering,
/obj/item/stack/sheet/mineral/plasma/fifty,
/obj/item/stack/sheet/mineral/plasma/fifty,
/obj/item/storage/toolbox/mechanical,
/obj/machinery/light,
/obj/structure/sign/poster/official/random{
	pixel_x = -32
	},
/obj/item/pipe_dispenser,
/turf/open/floor/carpet/executive,
/area/space)
"P" = (
/obj/machinery/power/terminal,
/obj/structure/cable,
/turf/open/floor/carpet/executive,
/area/space)
"S" = (
/obj/machinery/computer/monitor,
/turf/open/floor/carpet/executive,
/area/space)
"W" = (
/obj/machinery/power/smes/engineering,
/obj/structure/cable,
/turf/open/floor/plasteel{
	icon_state = "steel"
	},
/area/space)
"X" = (
/obj/machinery/power/shuttle/engine/electric{
	dir = 1
	},
/obj/structure/cable/yellow,
/turf/open/floor/plating,
/area/space)
"Y" = (
/obj/machinery/vending/security/marine/solgov,
/obj/machinery/light{
	dir = 1
	},
/obj/structure/sign/poster/official/random{
	pixel_x = 32
	},
/turf/open/floor/carpet/executive,
/area/space)

(1,1,1) = {"
a
a
a
a
a
a
a
a
a
a
a
a
a
a
a
a
a
a
a
a
a
a
a
a
a
a
a
a
a
a
a
a
a
a
a
a
a
a
a
a
"}
(2,1,1) = {"
a
a
a
a
a
a
a
a
a
a
a
a
a
a
a
a
a
a
a
a
a
a
a
a
a
a
a
a
a
a
a
a
a
a
a
a
a
a
a
a
"}
(3,1,1) = {"
a
a
a
a
a
a
a
a
a
a
a
a
a
a
a
a
a
a
a
a
a
a
a
a
a
a
a
a
a
a
a
a
a
a
a
a
a
a
a
a
"}
(4,1,1) = {"
a
a
a
a
a
a
a
a
a
a
a
a
a
a
a
a
a
a
a
a
a
a
a
a
a
a
a
a
a
a
a
a
a
a
a
a
a
a
a
a
"}
(5,1,1) = {"
a
a
a
a
a
a
a
a
a
a
a
a
a
a
a
a
a
a
a
a
a
a
a
a
a
a
a
a
a
a
a
a
a
a
a
a
a
a
a
a
"}
(6,1,1) = {"
a
a
a
a
a
a
a
a
a
a
a
a
a
a
a
a
a
a
a
a
a
a
a
a
a
a
a
a
a
a
a
a
a
a
a
a
a
a
a
a
"}
(7,1,1) = {"
a
a
a
a
a
a
a
a
a
a
a
a
a
a
a
a
a
a
a
a
a
a
a
a
a
a
a
a
a
a
a
a
a
a
a
a
a
a
a
a
"}
(8,1,1) = {"
a
a
a
a
a
a
a
a
a
a
a
a
a
a
a
a
a
a
a
a
a
a
a
a
a
a
a
a
a
a
a
a
a
a
a
a
a
a
a
a
"}
(9,1,1) = {"
a
a
a
a
a
a
a
a
a
a
a
a
a
a
a
a
a
a
a
a
a
a
a
a
a
a
a
a
a
a
a
a
a
a
a
a
a
a
a
a
"}
(10,1,1) = {"
a
a
a
a
a
a
a
a
a
a
a
a
a
a
a
a
a
a
a
a
a
a
a
a
a
a
a
a
a
a
a
a
a
a
a
a
a
a
a
a
"}
(11,1,1) = {"
a
a
a
a
a
a
a
a
a
a
a
a
a
a
a
a
a
a
a
a
a
a
a
a
a
a
a
a
a
a
a
a
a
a
a
a
a
a
a
a
"}
(12,1,1) = {"
a
a
a
a
a
a
a
a
a
a
a
a
a
a
a
a
a
a
a
a
a
a
a
a
a
a
a
a
a
a
a
a
a
a
a
a
a
a
a
a
"}
(13,1,1) = {"
a
a
a
a
a
a
a
a
a
a
a
a
a
a
a
a
a
a
a
a
a
a
a
a
a
a
a
a
a
a
a
a
a
a
a
a
a
a
a
a
"}
(14,1,1) = {"
a
a
a
a
a
a
a
a
a
a
a
a
a
a
a
a
a
a
a
a
a
a
a
a
a
a
a
a
a
a
a
a
a
a
a
a
a
a
a
a
"}
(15,1,1) = {"
a
a
a
a
a
a
a
a
a
a
a
a
a
a
a
a
a
a
a
a
a
a
a
a
a
a
a
a
a
a
a
a
a
a
a
a
a
a
a
a
"}
(16,1,1) = {"
a
a
a
a
a
a
a
a
a
a
a
a
a
a
a
a
a
a
a
a
a
a
a
a
a
a
a
a
a
a
a
a
a
a
a
a
a
a
a
a
"}
(17,1,1) = {"
a
a
a
a
a
a
a
a
a
a
a
a
a
a
a
a
a
a
a
a
a
a
a
a
a
a
a
a
a
a
a
a
a
a
a
a
a
a
a
a
"}
(18,1,1) = {"
a
a
a
a
a
a
a
a
a
a
a
a
a
a
a
a
a
a
a
a
a
a
a
a
a
a
a
a
a
a
a
a
a
a
a
a
a
a
a
a
"}
(19,1,1) = {"
a
a
a
a
a
a
a
a
a
a
a
a
a
a
a
a
a
a
a
a
a
a
a
a
a
a
a
a
a
a
a
a
a
a
a
a
a
a
a
a
"}
(20,1,1) = {"
a
a
a
a
a
a
a
a
a
a
a
a
a
a
a
a
a
a
a
a
a
a
a
a
a
a
a
a
a
a
a
a
a
a
a
a
a
a
a
a
"}
(21,1,1) = {"
a
a
a
a
a
a
a
a
a
a
a
a
a
a
a
a
a
a
a
a
a
a
a
a
a
a
a
a
a
a
a
a
a
a
a
a
a
a
a
a
"}
(22,1,1) = {"
a
a
a
a
a
a
a
a
a
a
a
a
a
a
a
a
a
a
a
a
a
a
a
a
a
a
a
a
a
a
a
a
a
a
a
a
a
a
a
a
"}
(23,1,1) = {"
a
a
a
a
a
a
a
a
a
a
a
a
a
a
a
a
a
a
a
a
a
a
a
a
a
a
a
a
a
a
a
a
a
a
a
a
a
a
a
a
"}
(24,1,1) = {"
a
a
a
a
a
a
a
a
a
a
a
a
a
a
a
a
a
a
a
a
a
a
a
a
a
a
a
a
a
a
a
a
a
a
a
a
a
a
a
a
"}
(25,1,1) = {"
a
a
a
a
a
a
a
a
a
a
a
a
a
a
a
a
a
a
a
a
a
a
a
a
a
a
a
a
a
a
a
a
a
a
a
a
a
a
a
a
"}
(26,1,1) = {"
a
a
a
a
a
a
a
a
a
a
a
a
a
a
a
a
a
a
a
a
a
a
a
a
a
a
a
a
a
a
a
a
a
a
a
a
a
a
a
a
"}
(27,1,1) = {"
a
a
a
a
a
a
a
a
a
a
a
a
a
a
a
a
a
a
a
a
a
a
a
a
a
a
a
a
a
a
a
a
a
a
a
a
a
a
a
a
"}
(28,1,1) = {"
a
a
a
a
a
a
a
a
a
a
a
a
a
a
a
a
a
a
a
a
a
a
a
a
a
a
a
a
a
a
a
a
a
a
a
a
a
a
a
a
"}
(29,1,1) = {"
a
a
a
a
a
a
a
a
a
a
a
a
a
a
a
a
a
a
a
a
a
a
a
a
a
a
a
a
a
a
a
a
a
a
a
a
a
a
a
a
"}
(30,1,1) = {"
a
a
a
a
a
a
a
a
a
a
a
a
a
a
a
a
a
a
a
a
a
a
a
a
a
a
a
a
a
a
a
a
a
a
a
a
a
a
a
a
"}
(31,1,1) = {"
a
a
a
a
a
a
a
a
a
a
a
a
a
a
a
a
a
a
a
a
a
a
l
v
n
v
v
l
w
v
a
a
a
a
a
a
a
a
a
a
"}
(32,1,1) = {"
a
a
a
a
a
a
a
a
a
a
a
a
a
a
a
a
a
a
a
a
a
l
l
h
x
M
G
C
C
v
v
a
a
a
a
a
a
a
a
a
"}
(33,1,1) = {"
a
a
a
a
a
a
a
a
a
a
a
a
a
a
a
a
a
a
a
a
l
l
S
x
x
x
x
x
x
O
v
v
a
a
a
a
a
a
a
a
"}
(34,1,1) = {"
a
a
a
a
a
a
a
a
a
a
a
a
a
a
a
a
a
a
a
a
l
B
x
z
x
x
x
f
N
P
u
X
a
a
a
a
a
a
a
a
"}
(35,1,1) = {"
a
a
a
a
a
a
a
a
a
a
a
a
a
a
a
a
a
a
a
a
l
l
s
x
x
x
x
j
K
J
v
v
a
a
a
a
a
a
a
a
"}
(36,1,1) = {"
a
a
a
a
a
a
a
a
a
a
a
a
a
a
a
a
a
a
a
a
a
l
l
Y
x
F
k
i
W
v
v
a
a
a
a
a
a
a
a
a
"}
(37,1,1) = {"
a
a
a
a
a
a
a
a
a
a
a
a
a
a
a
a
a
a
a
a
a
a
l
v
D
v
v
l
w
v
a
a
a
a
a
a
a
a
a
a
"}
(38,1,1) = {"
a
a
a
a
a
a
a
a
a
a
a
a
a
a
a
a
a
a
a
a
a
a
a
a
a
a
a
a
a
a
a
a
a
a
a
a
a
a
a
a
"}
(39,1,1) = {"
a
a
a
a
a
a
a
a
a
a
a
a
a
a
a
a
a
a
a
a
a
a
a
a
a
a
a
a
a
a
a
a
a
a
a
a
a
a
a
a
"}
(40,1,1) = {"
a
a
a
a
a
a
a
a
a
a
a
a
a
a
a
a
a
a
a
a
a
a
a
a
a
a
a
a
a
a
a
a
a
a
a
a
a
a
a
a
"}
(41,1,1) = {"
a
a
a
a
a
a
a
a
a
a
a
a
a
a
a
a
a
a
a
a
a
a
a
a
a
a
a
a
a
a
a
a
a
a
a
a
a
a
a
a
"}
(42,1,1) = {"
a
a
a
a
a
a
a
a
a
a
a
a
a
a
a
a
a
a
a
a
a
a
a
a
a
a
a
a
a
a
a
a
a
a
a
a
a
a
a
a
"}
(43,1,1) = {"
a
a
a
a
a
a
a
a
a
a
a
a
a
a
a
a
a
a
a
a
a
a
a
a
a
a
a
a
a
a
a
a
a
a
a
a
a
a
a
a
"}
(44,1,1) = {"
a
a
a
a
a
a
a
a
a
a
a
a
a
a
a
a
a
a
a
a
a
a
a
a
a
a
a
a
a
a
a
a
a
a
a
a
a
a
a
a
"}
(45,1,1) = {"
a
a
a
a
a
a
a
a
a
a
a
a
a
a
a
a
a
a
a
a
a
a
a
a
a
a
a
a
a
a
a
a
a
a
a
a
a
a
a
a
"}
(46,1,1) = {"
a
a
a
a
a
a
a
a
a
a
a
a
a
a
a
a
a
a
a
a
a
a
a
a
a
a
a
a
a
a
a
a
a
a
a
a
a
a
a
a
"}
(47,1,1) = {"
a
a
a
a
a
a
a
a
a
a
a
a
a
a
a
a
a
a
a
a
a
a
a
a
a
a
a
a
a
a
a
a
a
a
a
a
a
a
a
a
"}
(48,1,1) = {"
a
a
a
a
a
a
a
a
a
a
a
a
a
a
a
a
a
a
a
a
a
a
a
a
a
a
a
a
a
a
a
a
a
a
a
a
a
a
a
a
"}
(49,1,1) = {"
a
a
a
a
a
a
a
a
a
a
a
a
a
a
a
a
a
a
a
a
a
a
a
a
a
a
a
a
a
a
a
a
a
a
a
a
a
a
a
a
"}
(50,1,1) = {"
a
a
a
a
a
a
a
a
a
a
a
a
a
a
a
a
a
a
a
a
a
a
a
a
a
a
a
a
a
a
a
a
a
a
a
a
a
a
a
a
"}
(51,1,1) = {"
a
a
a
a
a
a
a
a
a
a
a
a
a
a
a
a
a
a
a
a
a
a
a
a
a
a
a
a
a
a
a
a
a
a
a
a
a
a
a
a
"}
(52,1,1) = {"
a
a
a
a
a
a
a
a
a
a
a
a
a
a
a
a
a
a
a
a
a
a
a
a
a
a
a
a
a
a
a
a
a
a
a
a
a
a
a
a
"}
(53,1,1) = {"
a
a
a
a
a
a
a
a
a
a
a
a
a
a
a
a
a
a
a
a
a
a
a
a
a
a
a
a
a
a
a
a
a
a
a
a
a
a
a
a
"}
(54,1,1) = {"
a
a
a
a
a
a
a
a
a
a
a
a
a
a
a
a
a
a
a
a
a
a
a
a
a
a
a
a
a
a
a
a
a
a
a
a
a
a
a
a
"}
(55,1,1) = {"
a
a
a
a
a
a
a
a
a
a
a
a
a
a
a
a
a
a
a
a
a
a
a
a
a
a
a
a
a
a
a
a
a
a
a
a
a
a
a
a
"}
(56,1,1) = {"
a
a
a
a
a
a
a
a
a
a
a
a
a
a
a
a
a
a
a
a
a
a
a
a
a
a
a
a
a
a
a
a
a
a
a
a
a
a
a
a
"}
