"bP" = (/obj/machinery/atmospherics/components/unary/vent_scrubber/on{dir = 4},/turf/open/floor/light/colour_cycle/dancefloor_b,/area/ship/engineering/engine)
"cm" = (/obj/structure/window/plasma/reinforced{dir = 4},/turf/open/floor/mineral/bananium,/area/ship/crew)
"cF" = (/turf/closed/wall/mineral/iron,/area/ship/engineering/engine)
"cN" = (/turf/closed/wall/mineral/iron,/area/ship/crew/dorm)
"dr" = (/obj/effect/spawner/structure/window/reinforced/indestructable,/obj/structure/grille,/obj/docking_port/mobile{dir = 2},/obj/structure/cable{icon_state = "0-2"},/turf/open/floor/plating,/area/ship/bridge)
"dy" = (/obj/structure/cable{icon_state = "4-8"},/obj/structure/cable{icon_state = "4-8"},/turf/open/floor/mineral/bananium,/area/ship/crew)
"dW" = (/obj/effect/spawner/structure/window/reinforced/indestructable,/obj/structure/grille,/turf/open/floor/plating,/area/ship/bridge)
"ek" = (/obj/structure/cable{icon_state = "1-2"},/obj/structure/cable{icon_state = "1-4"},/turf/open/floor/light/colour_cycle/dancefloor_b,/area/ship/engineering/engine)
"fx" = (/obj/machinery/light{dir = 8},/obj/machinery/vending/autodrobe/all_access,/turf/open/floor/mineral/bananium,/area/ship/crew)
"fB" = (/obj/structure/cable{icon_state = "1-2"},/obj/machinery/pipedispenser,/turf/open/floor/light/colour_cycle/dancefloor_a,/area/ship/engineering/engine)
"fL" = (/obj/structure/grille,/obj/effect/spawner/structure/window/reinforced,/turf/open/floor/plating,/area/ship/bridge)
"gg" = (/obj/item/reagent_containers/food/snacks/egg,/obj/item/reagent_containers/food/snacks/egg,/obj/item/reagent_containers/food/snacks/egg,/obj/item/reagent_containers/food/snacks/egg,/obj/item/reagent_containers/food/snacks/egg,/obj/structure/closet/secure_closet/freezer/fridge/open,/obj/item/reagent_containers/food/snacks/egg,/obj/item/reagent_containers/food/snacks/egg,/obj/item/reagent_containers/food/snacks/egg,/obj/item/reagent_containers/food/snacks/egg,/obj/item/reagent_containers/food/snacks/egg,/obj/item/reagent_containers/food/snacks/egg,/obj/item/reagent_containers/food/snacks/egg,/obj/item/reagent_containers/food/snacks/egg,/obj/item/reagent_containers/food/snacks/egg,/obj/item/reagent_containers/food/snacks/egg,/obj/item/reagent_containers/food/snacks/egg,/obj/item/reagent_containers/food/snacks/egg,/obj/item/reagent_containers/food/snacks/egg,/obj/item/reagent_containers/food/snacks/egg,/obj/item/reagent_containers/food/snacks/egg,/obj/item/reagent_containers/food/snacks/egg,/obj/item/reagent_containers/food/snacks/egg,/obj/item/reagent_containers/food/snacks/egg,/obj/item/reagent_containers/food/snacks/egg,/obj/item/reagent_containers/food/snacks/egg,/obj/item/reagent_containers/food/snacks/egg,/obj/item/reagent_containers/food/snacks/egg,/obj/item/reagent_containers/food/snacks/egg,/obj/item/reagent_containers/food/snacks/egg,/obj/item/reagent_containers/food/snacks/egg,/obj/item/reagent_containers/food/snacks/egg,/obj/item/reagent_containers/food/snacks/egg,/obj/item/reagent_containers/food/snacks/egg,/obj/item/reagent_containers/food/snacks/egg,/obj/item/reagent_containers/food/snacks/egg,/obj/item/reagent_containers/food/snacks/egg,/obj/item/reagent_containers/food/snacks/egg,/obj/item/reagent_containers/food/snacks/egg,/obj/item/reagent_containers/food/snacks/egg,/obj/item/reagent_containers/food/snacks/egg,/obj/item/reagent_containers/food/snacks/egg,/obj/item/reagent_containers/food/snacks/egg,/obj/item/reagent_containers/food/snacks/egg,/obj/item/reagent_containers/food/snacks/egg,/obj/item/reagent_containers/food/snacks/egg,/obj/item/reagent_containers/food/snacks/egg,/obj/item/reagent_containers/food/snacks/egg,/obj/item/reagent_containers/food/snacks/egg,/obj/item/reagent_containers/food/snacks/egg,/obj/item/reagent_containers/food/snacks/egg,/obj/item/reagent_containers/food/snacks/egg,/obj/item/reagent_containers/food/snacks/egg,/obj/item/reagent_containers/food/snacks/egg,/obj/item/reagent_containers/food/snacks/egg,/obj/item/reagent_containers/food/snacks/egg,/obj/item/reagent_containers/food/snacks/egg,/obj/item/reagent_containers/food/snacks/egg,/obj/item/reagent_containers/food/snacks/egg,/obj/item/reagent_containers/food/snacks/egg,/obj/item/reagent_containers/food/snacks/egg,/obj/item/reagent_containers/food/snacks/egg,/obj/item/reagent_containers/food/snacks/egg,/obj/item/reagent_containers/food/snacks/egg,/obj/item/reagent_containers/food/snacks/egg,/obj/item/reagent_containers/food/snacks/egg,/obj/item/reagent_containers/food/snacks/egg,/obj/item/reagent_containers/food/snacks/egg,/obj/item/reagent_containers/food/snacks/egg,/obj/item/reagent_containers/food/snacks/egg,/obj/item/reagent_containers/food/snacks/egg,/obj/item/reagent_containers/food/snacks/egg,/obj/item/reagent_containers/food/snacks/egg,/obj/item/reagent_containers/food/snacks/egg,/obj/item/reagent_containers/food/snacks/egg,/obj/item/reagent_containers/food/snacks/egg,/obj/item/reagent_containers/food/snacks/egg,/obj/item/reagent_containers/food/snacks/egg,/obj/item/reagent_containers/food/snacks/egg,/obj/item/reagent_containers/food/snacks/egg,/obj/item/reagent_containers/food/snacks/egg,/obj/item/reagent_containers/food/snacks/egg,/obj/item/reagent_containers/food/snacks/egg,/obj/item/reagent_containers/food/snacks/egg,/obj/item/reagent_containers/food/snacks/egg,/obj/item/reagent_containers/food/snacks/egg,/obj/item/reagent_containers/food/snacks/egg,/obj/item/reagent_containers/food/snacks/egg,/obj/item/reagent_containers/food/snacks/egg,/obj/item/reagent_containers/food/snacks/egg,/obj/item/reagent_containers/food/snacks/egg,/obj/item/reagent_containers/food/snacks/egg,/obj/item/reagent_containers/food/snacks/egg,/obj/item/reagent_containers/food/snacks/egg,/obj/item/reagent_containers/food/snacks/egg,/obj/item/reagent_containers/food/snacks/egg,/obj/item/reagent_containers/food/snacks/egg,/obj/item/reagent_containers/food/snacks/egg,/obj/item/reagent_containers/food/snacks/egg,/obj/item/reagent_containers/food/snacks/egg,/obj/item/reagent_containers/food/snacks/egg,/obj/item/reagent_containers/food/snacks/egg,/obj/item/reagent_containers/food/snacks/egg,/obj/item/reagent_containers/food/snacks/egg,/obj/item/reagent_containers/food/snacks/egg,/obj/item/reagent_containers/food/snacks/egg,/obj/item/reagent_containers/food/snacks/egg,/obj/item/reagent_containers/food/snacks/egg,/obj/item/reagent_containers/food/snacks/egg,/obj/item/reagent_containers/food/snacks/egg,/obj/item/reagent_containers/food/snacks/egg,/obj/item/reagent_containers/food/snacks/egg,/obj/item/reagent_containers/food/snacks/egg,/obj/item/reagent_containers/food/snacks/egg,/obj/item/reagent_containers/food/snacks/egg,/obj/item/reagent_containers/food/snacks/egg,/obj/item/reagent_containers/food/snacks/egg,/obj/item/reagent_containers/food/snacks/egg,/obj/item/reagent_containers/food/snacks/egg,/obj/item/reagent_containers/food/snacks/egg,/obj/item/reagent_containers/food/snacks/egg,/obj/item/reagent_containers/food/snacks/egg,/obj/item/reagent_containers/food/snacks/egg,/obj/item/reagent_containers/food/snacks/egg,/turf/open/floor/mineral/bananium,/area/ship/crew)
"gp" = (/turf/closed/wall/mineral/iron,/area/ship/crew)
"gN" = (/turf/closed/wall/mineral/iron,/area/ship/bridge)
"hf" = (/obj/machinery/vending/hydronutrients,/turf/open/floor/mineral/bananium,/area/ship/crew)
"hv" = (/obj/machinery/computer/helm,/obj/item/areaeditor/shuttle,/turf/open/floor/wood/yew,/area/ship/bridge)
"hB" = (/turf/open/floor/mineral/bananium,/area/ship/crew/dorm)
"iB" = (/obj/structure/window/plasma/reinforced,/obj/machinery/disposal/deliveryChute{dir = 1},/obj/structure/disposalpipe/trunk,/obj/structure/cable{icon_state = "1-2"},/turf/open/floor/mineral/bananium,/area/ship/crew)
"iN" = (/obj/structure/window/plasma/reinforced{dir = 8},/obj/machinery/light,/obj/item/stack/sheet/mineral/plasma/twenty,/turf/open/floor/mineral/bananium,/area/ship/crew)
"kh" = (/obj/machinery/airalarm/all_access,/turf/closed/wall/mineral/iron,/area/ship/engineering/engine)
"kz" = (/obj/machinery/computer/autopilot,/turf/open/floor/wood/yew,/area/ship/bridge)
"lc" = (/obj/structure/chair/comfy/shuttle,/obj/machinery/light{dir = 8},/turf/open/floor/wood/yew,/area/ship/bridge)
"mc" = (/obj/structure/cable{icon_state = "0-2"},/obj/machinery/power/apc/auto_name/east,/turf/open/floor/wood/yew,/area/ship/bridge)
"mn" = (/obj/structure/tank_dispenser/oxygen,/turf/open/floor/mineral/bananium,/area/ship/crew)
"mV" = (/obj/machinery/atmospherics/components/unary/thermomachine/freezer/on,/obj/structure/cable{icon_state = "1-2"},/turf/open/floor/light/colour_cycle/dancefloor_a,/area/ship/engineering/engine)
"no" = (/obj/structure/table/wood/fancy/royalblue,/obj/item/reagent_containers/food/snacks/grown/banana,/obj/item/reagent_containers/food/snacks/grown/banana,/obj/item/reagent_containers/food/snacks/grown/banana,/turf/open/floor/mineral/bananium,/area/ship/crew)
"ns" = (/obj/machinery/door/airlock/bananium/glass,/obj/item/grown/bananapeel/bluespace{alpha = 30},/turf/open/floor/mineral/bananium,/area/ship/bridge)
"nT" = (/obj/machinery/atmospherics/components/unary/passive_vent,/turf/open/floor/plating,/area/ship/crew)
"ot" = (/obj/structure/cable{icon_state = "1-8"},/obj/machinery/light,/turf/open/floor/mineral/bananium,/area/ship/crew)
"oK" = (/obj/machinery/door/airlock/bananium/glass,/obj/item/grown/bananapeel/bluespace{alpha = 30},/obj/structure/cable{icon_state = "1-2"},/turf/open/floor/mineral/bananium,/area/ship/bridge)
"pD" = (/obj/structure/window/plasma/reinforced{dir = 4},/obj/machinery/portable_atmospherics/canister/nitrogen,/obj/machinery/light,/turf/open/floor/mineral/bananium,/area/ship/crew)
"qU" = (/obj/structure/fans/tiny,/turf/open/floor/light/colour_cycle/dancefloor_b,/area/ship/engineering/engine)
"rz" = (/obj/structure/cable{icon_state = "1-2"},/turf/open/floor/mineral/bananium,/area/ship/crew)
"rT" = (/obj/structure/fans/tiny,/obj/machinery/door/poddoor{id = honkext3},/obj/item/grown/bananapeel/bluespace{alpha = 30},/turf/open/floor/mineral/bananium,/area/ship/crew)
"rY" = (/obj/structure/fans/tiny,/turf/open/floor/light/colour_cycle/dancefloor_a,/area/ship/engineering/engine)
"sf" = (/obj/structure/window/plasma/reinforced,/obj/structure/disposaloutlet{dir = 1},/obj/structure/disposalpipe/trunk{dir = 2},/turf/open/floor/mineral/bananium,/area/ship/crew)
"sC" = (/obj/structure/fans/tiny,/obj/item/restraints/legcuffs/beartrap,/obj/machinery/power/terminal,/obj/structure/cable,/turf/open/floor/light/colour_cycle/dancefloor_b,/area/ship/engineering/engine)
"tB" = (/obj/machinery/cryopod{dir = 1},/turf/open/floor/mineral/bananium,/area/ship/crew/dorm)
"tF" = (/obj/machinery/atmospherics/components/unary/vent_pump{dir = 8},/turf/open/floor/light/colour_cycle/dancefloor_a,/area/ship/engineering/engine)
"wg" = (/obj/structure/disposaloutlet,/obj/structure/disposalpipe/trunk{dir = 1},/obj/structure/cable{icon_state = "1-2"},/turf/open/floor/light/colour_cycle/dancefloor_a,/area/ship/engineering/engine)
"wk" = (/obj/structure/table/wood/fancy/royalblue,/obj/item/toy/crayon/spraycan/lubecan,/obj/item/toy/crayon/spraycan/lubecan,/turf/open/floor/mineral/bananium,/area/ship/crew)
"wr" = (/obj/machinery/light{dir = 8},/obj/structure/closet/crate,/turf/open/floor/mineral/bananium,/area/ship/crew)
"wM" = (/obj/structure/window/reinforced/fulltile,/obj/structure/grille,/obj/item/pipe,/obj/structure/grille,/turf/open/floor/plating,/area/ship/crew)
"xT" = (/obj/machinery/atmospherics/components/unary/vent_scrubber/on{dir = 4},/turf/open/floor/light/colour_cycle/dancefloor_a,/area/ship/engineering/engine)
"yr" = (/obj/structure/closet/crate,/turf/open/floor/mineral/bananium,/area/ship/crew)
"yI" = (/obj/structure/fans/tiny,/obj/machinery/door/poddoor{id = honkext3},/obj/machinery/button/door{id = honkext3; pixel_y = -25},/obj/item/grown/bananapeel/bluespace{alpha = 30},/turf/open/floor/mineral/bananium,/area/ship/crew)
"yP" = (/obj/structure/cable{icon_state = "1-2"},/turf/open/floor/light/colour_cycle/dancefloor_b,/area/ship/engineering/engine)
"zv" = (/obj/structure/cable{icon_state = "4-8"},/turf/open/floor/mineral/bananium,/area/ship/crew)
"AM" = (/obj/structure/window{dir = 4},/obj/structure/window{dir = 8},/obj/machinery/door/window,/obj/structure/table/wood/fancy,/obj/item/dnainjector/timed/h2m,/obj/item/dnainjector/timed/h2m,/turf/open/floor/mineral/bananium,/area/ship/crew)
"AY" = (/turf/open/floor/light/colour_cycle/dancefloor_a,/area/ship/engineering/engine)
"Bj" = (/obj/machinery/power/emitter,/obj/structure/cable,/turf/open/floor/light/colour_cycle/dancefloor_a,/area/ship/engineering/engine)
"BK" = (/obj/machinery/autolathe,/turf/open/floor/mineral/bananium,/area/ship/crew)
"Cy" = (/obj/machinery/biogenerator,/obj/item/reagent_containers/glass/beaker,/turf/open/floor/mineral/bananium,/area/ship/crew)
"CJ" = (/obj/structure/window/plasma/reinforced,/obj/structure/cable{icon_state = "1-2"},/turf/open/floor/mineral/bananium,/area/ship/crew)
"Dh" = (/obj/machinery/atmospherics/components/unary/vent_pump{dir = 8},/turf/open/floor/light/colour_cycle/dancefloor_b,/area/ship/engineering/engine)
"Do" = (/obj/structure/window/plasma/reinforced,/turf/open/floor/mineral/bananium,/area/ship/crew)
"Dt" = (/obj/machinery/power/supermatter_crystal/shard,/turf/open/floor/light/colour_cycle/dancefloor_b,/area/ship/engineering/engine)
"DN" = (/turf/open/space/basic,/area/space)
"El" = (/mob/living/carbon/monkey,/obj/structure/cable{icon_state = "1-2"},/turf/open/floor/light/colour_cycle/dancefloor_b,/area/ship/engineering/engine)
"EC" = (/obj/item/stack/sheet/glass/fifty,/obj/item/stack/sheet/metal/fifty,/obj/item/stack/sheet/metal/fifty,/turf/open/floor/mineral/bananium,/area/ship/crew)
"ES" = (/obj/machinery/disposal/deliveryChute,/obj/structure/disposalpipe/trunk{dir = 1},/turf/open/floor/light/colour_cycle/dancefloor_b,/area/ship/engineering/engine)
"FK" = (/obj/structure/cable{icon_state = "0-2"},/obj/machinery/power/apc/auto_name/north,/turf/open/floor/mineral/bananium,/area/ship/crew)
"Hr" = (/obj/structure/table/glass,/obj/item/gun/ballistic/revolver/russian,/obj/item/clothing/head/clownmitre,/obj/item/storage/toolbox/mechanical,/obj/machinery/light{dir = 4},/obj/item/pneumatic_cannon/pie/selfcharge,/obj/item/nullrod/clown,/obj/item/clothing/neck/petcollar,/obj/item/bikehorn/golden,/turf/open/floor/mineral/bananium,/area/ship/crew)
"HB" = (/obj/machinery/seed_extractor,/turf/open/floor/mineral/bananium,/area/ship/crew)
"IT" = (/obj/item/pet_carrier,/turf/open/floor/mineral/bananium,/area/ship/crew)
"Km" = (/obj/machinery/atmospherics/components/unary/thermomachine/freezer/on,/turf/open/floor/light/colour_cycle/dancefloor_b,/area/ship/engineering/engine)
"Ko" = (/obj/vehicle/ridden/scooter/skateboard,/turf/open/floor/mineral/bananium,/area/ship/crew)
"KF" = (/obj/machinery/deepfryer,/turf/open/floor/light/colour_cycle/dancefloor_b,/area/ship/engineering/engine)
"KH" = (/obj/machinery/computer/cryopod,/turf/closed/wall/mineral/iron,/area/ship/crew/dorm)
"MV" = (/obj/structure/cable{icon_state = "2-4"},/obj/structure/cable{icon_state = "4-8"},/turf/open/floor/mineral/bananium,/area/ship/crew)
"Nf" = (/obj/structure/reagent_dispensers/watertank/high,/obj/item/reagent_containers/glass/bucket,/turf/open/floor/mineral/bananium,/area/ship/crew)
"Nj" = (/obj/machinery/mineral/ore_redemption,/turf/open/floor/mineral/bananium,/area/ship/crew)
"Os" = (/obj/machinery/ore_silo,/turf/open/floor/mineral/bananium,/area/ship/crew)
"OU" = (/obj/machinery/atmospherics/components/unary/vent_scrubber/on/layer4,/obj/structure/cable,/obj/machinery/power/apc/auto_name/south,/turf/open/floor/light/colour_cycle/dancefloor_a,/area/ship/engineering/engine)
"Pd" = (/mob/living/simple_animal/pet/penguin/emperor/shamebrero{desc = "Weakest Clown Player."; icon = 'icons/mob/clown_mobs.dmi'; icon_living = "chlown"; icon_state = "chlown"; name = "Chlowne"},/turf/open/floor/mineral/bananium,/area/ship/crew)
"Po" = (/obj/machinery/hydroponics/constructable,/obj/item/seeds/banana{growthstages = 2; potency = 75; production = 2; yield = 9},/turf/open/floor/mineral/bananium,/area/ship/crew)
"QD" = (/obj/structure/rack,/obj/item/clothing/suit/space/hardsuit/clown,/obj/item/pickaxe/drill,/obj/item/storage/bag/ore,/obj/item/clothing/shoes/clown_shoes/banana_shoes,/obj/item/stack/sheet/mineral/bananium,/turf/open/floor/mineral/bananium,/area/ship/crew)
"QS" = (/obj/structure/cable{icon_state = "1-2"},/obj/machinery/power/port_gen/pacman,/turf/open/floor/light/colour_cycle/dancefloor_b,/area/ship/engineering/engine)
"RJ" = (/obj/structure/rack,/obj/item/clothing/suit/space/hardsuit/clown,/obj/item/pickaxe/drill,/obj/item/storage/bag/ore,/obj/structure/window{dir = 8},/obj/item/clothing/shoes/clown_shoes/banana_shoes,/obj/item/stack/sheet/mineral/bananium,/turf/open/floor/mineral/bananium,/area/ship/crew)
"SM" = (/obj/structure/rack,/obj/item/clothing/suit/space/hardsuit/clown,/obj/item/pickaxe/drill,/obj/item/storage/bag/ore,/obj/machinery/light{dir = 4},/obj/item/clothing/shoes/clown_shoes/banana_shoes,/obj/item/stack/sheet/mineral/bananium,/turf/open/floor/mineral/bananium,/area/ship/crew)
"SP" = (/obj/machinery/atmospherics/components/unary/outlet_injector/atmos/air_input{dir = 1},/obj/item/storage/book/bible/koran,/turf/open/floor/plating,/area/ship/crew)
"TE" = (/obj/structure/fans/tiny,/obj/machinery/power/rad_collector/anchored,/obj/structure/cable,/turf/open/floor/light/colour_cycle/dancefloor_a,/area/ship/engineering/engine)
"TN" = (/obj/structure/window/plasma/reinforced{dir = 4},/obj/machinery/portable_atmospherics/canister/nitrogen,/turf/open/floor/mineral/bananium,/area/ship/crew)
"Up" = (/obj/item/pipe/binary,/turf/closed/wall/mineral/iron,/area/ship/crew)
"Uv" = (/obj/machinery/airalarm/all_access,/turf/closed/wall/mineral/iron,/area/ship/crew)
"UO" = (/obj/machinery/power/smes/shuttle/precharged{dir = 1},/obj/structure/window/plasma/reinforced,/obj/structure/cable{icon_state = "0-2"},/turf/open/floor/plating,/area/ship/engineering/engine)
"UV" = (/obj/machinery/power/shuttle/engine/electric{dir = 1},/obj/structure/cable,/turf/open/floor/plating,/area/ship/engineering/engine)
"Vc" = (/obj/machinery/atmospherics/components/unary/tank/air,/turf/open/floor/mineral/bananium,/area/ship/crew)
"Vl" = (/obj/machinery/atmospherics/components/unary/vent_pump/high_volume/on{dir = 8},/turf/open/floor/mineral/bananium,/area/ship/crew)
"VZ" = (/obj/machinery/jukebox/disco,/obj/structure/fans/tiny,/turf/open/floor/light/colour_cycle/dancefloor_b,/area/ship/engineering/engine)
"Wl" = (/turf/open/floor/plating,/area/ship/crew)
"Wr" = (/obj/effect/decal/remains/human,/obj/item/clothing/mask/gas/mime,/turf/open/floor/light/colour_cycle/dancefloor_a,/area/ship/engineering/engine)
"WJ" = (/obj/structure/window/plasma/reinforced{dir = 8},/turf/open/floor/mineral/bananium,/area/ship/crew)
"Xf" = (/obj/structure/cable{icon_state = "1-2"},/turf/open/floor/light/colour_cycle/dancefloor_a,/area/ship/engineering/engine)
"Xn" = (/turf/open/floor/mineral/bananium,/area/ship/crew)
"XR" = (/obj/machinery/atmospherics/components/unary/vent_scrubber/on{dir = 1},/turf/open/floor/mineral/bananium,/area/ship/crew)
"Yd" = (/obj/structure/cable{icon_state = "1-4"},/obj/structure/bed/dogbed,/turf/open/floor/mineral/bananium,/area/ship/crew)
"Yi" = (/obj/structure/catwalk,/turf/closed/wall/mineral/iron,/area/ship/crew)
"YU" = (/obj/structure/fans/tiny,/obj/structure/cable{icon_state = "2-8"},/turf/open/floor/light/colour_cycle/dancefloor_a,/area/ship/engineering/engine)
"YY" = (/obj/structure/cable{icon_state = "4-8"},/obj/structure/table/wood/fancy/royalblue,/obj/machinery/microwave,/turf/open/floor/mineral/bananium,/area/ship/crew)
"Zp" = (/obj/structure/tank_dispenser/plasma,/turf/open/floor/mineral/bananium,/area/ship/crew)
"ZI" = (/obj/structure/cable{icon_state = "4-8"},/obj/structure/table/wood/fancy/royalblue,/obj/item/storage/box/donkpockets/donkpockethonk,/obj/item/storage/box/donkpockets/donkpockethonk,/obj/item/storage/box/donkpockets/donkpockethonk,/obj/item/storage/box/donkpockets/donkpockethonk,/turf/open/floor/mineral/bananium,/area/ship/crew)

(1,1,1) = {"
DNDNDNDNDNDNDNDNDNDNDNDNDNDNDNDNDNDNDNDNDNDNDNdrdWDN
DNDNDNDNDNDNDNDNDNDNDNDNDNDNDNDNDNDNDNDNDNDNfLfLfLfL
DNDNDNDNDNDNDNDNDNDNDNDNDNDNDNDNDNDNDNDNDNDNgNhvkzgN
DNDNDNDNDNDNDNDNDNDNDNDNDNDNDNDNDNDNDNDNDNDNgNlcmcgN
DNDNDNDNDNDNDNDNDNDNDNDNDNDNDNDNDNDNDNDNDNgpgNnsoKgN
DNDNDNDNDNDNDNDNDNDNDNDNDNDNDNDNDNDNDNDNDNgpXnXnrzrT
DNDNDNDNDNDNDNDNDNDNDNDNDNDNDNDNDNDNDNDNgpgpXnXnrzrT
DNDNDNDNDNDNDNDNDNDNDNDNDNDNDNDNDNDNDNDNgpwrXnXnrzrT
DNDNDNDNDNDNDNDNDNDNDNDNDNDNDNDNDNDNDNgpgpyrXnXnrzrT
gpgpgpDNDNDNDNDNDNDNDNDNDNDNDNDNDNDNgpgpAMXnXnXnrzrT
gpBKgpgpgpDNDNDNDNDNDNDNDNDNDNDNDNgpgpCyXnXnXnXnrzrT
gpECFKHrgpgpgpDNDNDNDNDNDNDNDNgpgpgpHBXnXnXnXnXnrzrT
gpITrzKoNjOsgpgpgpgpDNnTgpgpgpgpfxhfXnXnXnXnXnXnrzrT
gpgprzPdXnXnRJQDSMgpgpUpUvVcVlXnXnXnXnXnXnXnXnXnrzrT
WlgprzXnXnXnXnXnXnXnXnXRXnXnXnXnXnXnXnXnXnXnXnXnrzrT
DNgpYdzvzvYYZIzvzvzvMVdyMVzvMVzvMVzvzvzvzvzvzvzvotyI
DNgpgpXnXnnowkXnXnXniBsfCJDoCJDoCJXnXnXnXnXnXngggpgp
DNDNgpgpXnXnXnXnXncmwgESmVKmmVKFfBWJXnXnXnXnXnmngpDN
DNDNDNgpgpXnXnXnXncmyPAYyPAYyPAYElWJXnXnXnXnNfgpgpDN
DNDNDNDNgpgphBhBhBTNXfqUTEVZTEqUXfWJXnXnPoPogpgpDNDN
DNDNDNDNDNgpKHtBhBpDekYUDhWrbPrYQSiNXnZpgpgpgpDNDNDN
DNDNDNDNDNDNcNcNcNgpOUsCtFDtxTqUBjgpwMgpgpDNDNDNDNDN
DNDNDNDNDNDNDNDNDNYicFUOcFcFcFkhcFgpSPDNDNDNDNDNDNDN
DNDNDNDNDNDNDNDNDNDNDNUVDNDNDNDNDNDNDNDNDNDNDNDNDNDN
"}
