"aS" = (/obj/structure/cable{icon_state = "1-2"},/obj/structure/cable{icon_state = "2-4"},/obj/structure/cable{icon_state = "1-4"},/obj/machinery/atmospherics/pipe/simple/scrubbers/hidden/layer2{dir = 4},/turf/open/floor/mineral/plastitanium/red/brig,/area/ship/security)
"bp" = (/obj/structure/table/optable{dir = 4},/turf/open/floor/mineral/titanium/blue,/area/ship/medical)
"cB" = (/turf/closed/wall/mineral/titanium{color = "#2e2b30"},/area/ship/external)
"dk" = (/turf/closed/wall/mineral/titanium{color = "#3a1f4d"},/area/ship/engineering)
"ds" = (/obj/machinery/vending/security,/turf/closed/wall/mineral/titanium{color = "#3a1f4d"},/area/ship/security)
"dL" = (/obj/structure/cable{icon_state = "2-8"},/obj/machinery/power/apc/auto_name/north,/obj/structure/cable{icon_state = "0-2"},/turf/open/floor/mineral/titanium,/area/ship/science)
"ey" = (/obj/structure/cable{icon_state = "1-2"},/obj/machinery/atmospherics/pipe/manifold/brown/visible,/obj/machinery/atmospherics/pipe/simple/scrubbers/hidden/layer2{dir = 3},/turf/open/floor/mineral/titanium/yellow,/area/ship/engineering)
"eF" = (/turf/closed/wall/mineral/titanium{color = "#3a1f4d"},/area/ship/hallway/central)
"fd" = (/obj/structure/cable{icon_state = "1-2"},/obj/structure/cable{icon_state = "1-4"},/obj/structure/cable{icon_state = "2-4"},/obj/machinery/atmospherics/pipe/manifold/scrubbers/visible/layer2{dir = 8},/turf/open/floor/mineral/titanium/yellow,/area/ship/engineering)
"fQ" = (/turf/closed/wall/mineral/titanium{color = "#3a1f4d"},/area/ship/medical)
"fX" = (/turf/closed/wall/mineral/titanium{color = "#2e2b30"},/area/ship/hallway/central)
"gf" = (/obj/machinery/power/terminal{dir = 1},/obj/machinery/atmospherics/pipe/simple/orange/visible{dir = 4},/obj/machinery/power/port_gen/pacman,/obj/item/stack/sheet/mineral/plasma/twenty,/turf/open/floor/mineral/titanium/yellow,/area/ship/engineering)
"gz" = (/obj/machinery/computer/operating{dir = 1},/obj/machinery/light,/turf/open/floor/mineral/titanium/blue,/area/ship/medical)
"gK" = (/obj/structure/rack,/obj/item/clothing/gloves/color/yellow,/obj/item/clothing/gloves/color/yellow,/obj/item/clothing/gloves/color/yellow,/obj/item/clothing/gloves/color/yellow,/obj/item/clothing/gloves/color/yellow,/obj/item/storage/belt/utility/full/engi,/obj/item/storage/belt/utility/full/engi,/obj/item/storage/belt/utility/full/engi,/obj/item/storage/belt/utility/full/engi,/obj/item/storage/belt/utility/full/engi,/obj/item/stack/sheet/metal/ten,/obj/item/stack/sheet/glass/fifty,/obj/item/clothing/suit/space/hardsuit/ert/engi,/obj/item/clothing/suit/space/hardsuit/ert/engi,/obj/item/multitool,/obj/item/multitool,/obj/item/multitool,/obj/item/multitool,/obj/item/multitool,/turf/open/floor/mineral/titanium/yellow,/area/ship/engineering)
"gX" = (/obj/structure/cable{icon_state = "1-8"},/obj/machinery/atmospherics/pipe/simple/scrubbers/hidden/layer2{dir = 9},/turf/open/floor/mineral/plastitanium/red/brig,/area/ship/security)
"hS" = (/obj/structure/cable{icon_state = "4-8"},/obj/machinery/atmospherics/pipe/simple/scrubbers/hidden/layer2{dir = 4},/turf/open/floor/mineral/titanium,/area/ship/hallway/central)
"hU" = (/obj/machinery/atmospherics/pipe/simple/scrubbers/visible/layer2{dir = 8},/turf/closed/wall/mineral/titanium{color = "#3a1f4d"},/area/ship/hallway/central)
"iE" = (/obj/structure/table/glass,/obj/item/defibrillator/loaded,/obj/item/storage/firstaid/brute,/obj/item/storage/firstaid/fire,/obj/item/storage/firstaid/toxin,/obj/item/storage/firstaid/o2,/obj/item/storage/firstaid/advanced,/obj/machinery/light{dir = 1},/turf/open/floor/mineral/titanium/blue,/area/ship/medical)
"jg" = (/obj/structure/cable{icon_state = "4-8"},/obj/machinery/atmospherics/pipe/simple/scrubbers/hidden/layer2{dir = 8},/turf/open/floor/mineral/titanium,/area/ship/science)
"kc" = (/obj/machinery/atmospherics/components/unary/vent_scrubber/on/layer2{dir = 4},/turf/open/floor/mineral/titanium,/area/ship/science)
"ku" = (/obj/machinery/power/shuttle/engine/electric{dir = 4},/obj/structure/fans/tiny/invisible,/turf/closed/wall/mineral/titanium{color = "#2e2b30"},/area/ship/hallway/central)
"kA" = (/obj/item/reagent_containers/food/snacks/canned/beans{pixel_x = -5; pixel_y = 3},/obj/item/reagent_containers/food/snacks/canned/beans{pixel_x = 2; pixel_y = 3},/obj/item/reagent_containers/food/snacks/canned/beans{pixel_x = -2},/obj/item/reagent_containers/food/drinks/waterbottle/large{pixel_x = 5},/obj/item/reagent_containers/food/drinks/waterbottle/large{pixel_x = 1; pixel_y = -3},/obj/item/reagent_containers/food/drinks/waterbottle/large{pixel_x = 8; pixel_y = -3},/obj/structure/closet/crate{name = "food crate"},/obj/item/storage/cans/sixbeer,/obj/item/reagent_containers/food/snacks/rationpack,/obj/item/reagent_containers/food/snacks/rationpack,/obj/item/reagent_containers/food/snacks/rationpack,/obj/item/reagent_containers/food/snacks/rationpack,/obj/item/reagent_containers/food/snacks/rationpack,/obj/item/reagent_containers/food/snacks/rationpack,/turf/open/floor/mineral/titanium,/area/ship/hallway/central)
"kT" = (/obj/item/grown/bananapeel,/obj/item/clothing/accessory/fan_clown_pin,/obj/effect/decal/cleanable/blood,/obj/effect/decal/cleanable/xenoblood/xgibs/larva,/obj/effect/mob_spawn/human/clown/corpse,/obj/item/seeds/banana/bluespace,/turf/open/floor/mineral/titanium,/area/ship/hallway/central)
"le" = (/obj/machinery/vending/security/marine/solgov,/turf/closed/wall/mineral/titanium{color = "#3a1f4d"},/area/ship/security)
"lN" = (/obj/machinery/airalarm/directional/west,/obj/machinery/light{dir = 8},/turf/open/floor/mineral/titanium,/area/ship/science)
"mJ" = (/obj/machinery/atmospherics/components/unary/vent_scrubber/on/layer2,/turf/open/floor/mineral/titanium/blue,/area/ship/medical)
"nG" = (/obj/structure/tank_dispenser/oxygen,/turf/closed/wall/mineral/titanium{color = "#2e2b30"},/area/ship/science)
"nX" = (/obj/structure/cable{icon_state = "2-8"},/obj/machinery/atmospherics/pipe/simple/scrubbers/hidden/layer2{dir = 10},/turf/open/floor/mineral/plastitanium,/area/ship/bridge)
"oT" = (/obj/structure/table/optable{dir = 4},/obj/machinery/airalarm/directional/west,/turf/open/floor/mineral/titanium/blue,/area/ship/medical)
"pb" = (/turf/closed/wall/mineral/titanium{color = "#2e2b30"},/area/ship/engineering)
"pf" = (/obj/item/storage/backpack/duffelbag/med/surgery,/obj/item/book/manual/wiki/surgery,/obj/item/clothing/suit/space/hardsuit/medical/cmo,/obj/item/clothing/suit/space/hardsuit/medical,/obj/structure/table/glass,/turf/open/floor/mineral/titanium/blue,/area/ship/medical)
"pw" = (/obj/structure/cable{icon_state = "1-8"},/obj/machinery/atmospherics/pipe/simple/scrubbers/hidden/layer2,/turf/open/floor/mineral/plastitanium/red/brig,/area/ship/security)
"pN" = (/obj/machinery/power/apc/auto_name/south,/obj/structure/cable{icon_state = "0-8"},/obj/machinery/atmospherics/components/unary/vent_scrubber/on/layer2{dir = 8},/turf/open/floor/mineral/titanium/yellow,/area/ship/engineering)
"pS" = (/obj/structure/cable{icon_state = "1-2"},/obj/structure/cable{icon_state = "2-4"},/obj/machinery/atmospherics/pipe/manifold/scrubbers/visible/layer2{dir = 1},/turf/open/floor/mineral/titanium,/area/ship/science)
"qH" = (/obj/structure/cable{icon_state = "1-2"},/turf/open/floor/mineral/plastitanium,/area/ship/bridge)
"ru" = (/obj/structure/tank_dispenser/oxygen,/turf/closed/wall/mineral/titanium{color = "#2e2b30"},/area/ship/hallway/central)
"rC" = (/obj/structure/cable{icon_state = "2-4"},/obj/structure/table/reinforced,/obj/item/gun_voucher,/obj/item/gun_voucher,/obj/item/gun_voucher,/obj/item/gun_voucher,/obj/item/gun_voucher,/obj/machinery/airalarm/directional/north,/turf/open/floor/mineral/plastitanium/red/brig,/area/ship/security)
"rO" = (/obj/machinery/power/smes/shuttle/precharged{dir = 4},/obj/structure/fans/tiny/invisible,/turf/closed/wall/mineral/titanium{color = "#2e2b30"},/area/ship/science)
"ur" = (/turf/closed/wall/mineral/titanium{color = "#3a1f4d"},/area/ship/external)
"uW" = (/obj/structure/cable{icon_state = "1-2"},/obj/machinery/atmospherics/pipe/manifold/scrubbers/visible/layer2{dir = 4},/turf/open/floor/mineral/titanium,/area/ship/hallway/central)
"vN" = (/obj/machinery/power/terminal{dir = 8},/obj/structure/cable{icon_state = "0-4"},/turf/open/floor/mineral/titanium,/area/ship/science)
"vZ" = (/obj/structure/cable{icon_state = "1-2"},/turf/open/floor/mineral/titanium,/area/ship/science)
"wi" = (/obj/machinery/power/terminal{dir = 8},/obj/structure/cable{icon_state = "0-4"},/turf/open/floor/mineral/titanium,/area/ship/hallway/central)
"wB" = (/obj/machinery/light{dir = 4},/turf/open/floor/mineral/plastitanium/red/brig,/area/ship/security)
"xI" = (/obj/structure/cable{icon_state = "1-8"},/obj/structure/cable{icon_state = "2-8"},/obj/machinery/atmospherics/pipe/simple/orange/visible{dir = 6},/obj/machinery/atmospherics/pipe/simple/scrubbers/hidden/layer2{dir = 3},/turf/open/floor/mineral/titanium/yellow,/area/ship/engineering)
"yb" = (/obj/structure/cable{icon_state = "2-4"},/obj/structure/cable{icon_state = "1-4"},/obj/machinery/atmospherics/pipe/manifold/scrubbers/visible/layer2{dir = 1},/turf/open/floor/mineral/titanium/blue,/area/ship/medical)
"yc" = (/turf/open/floor/mineral/titanium,/area/ship/science)
"zX" = (/obj/structure/lattice/catwalk,/obj/machinery/atmospherics/components/unary/passive_vent/layer2{dir = 4},/turf/open/space/basic,/area/ship/external)
"Ai" = (/obj/structure/cable{icon_state = "2-4"},/obj/machinery/atmospherics/pipe/simple/scrubbers/hidden/layer2,/turf/open/floor/mineral/plastitanium/red/brig,/area/ship/security)
"As" = (/obj/machinery/door/airlock/external/glass,/obj/structure/fans/tiny,/turf/open/floor/mineral/titanium,/area/ship/hallway/central)
"AL" = (/turf/closed/wall/mineral/titanium{color = "#3a1f4d"},/area/ship/science)
"BE" = (/obj/machinery/door/airlock/engineering/glass,/obj/structure/fans/tiny/invisible,/obj/machinery/atmospherics/pipe/manifold/scrubbers/visible/layer2{dir = 4},/turf/open/floor/mineral/titanium,/area/ship/hallway/central)
"Cg" = (/obj/machinery/door/airlock/medical/glass,/obj/structure/fans/tiny/invisible,/obj/structure/cable{icon_state = "4-8"},/obj/machinery/atmospherics/pipe/simple/scrubbers/hidden/layer2{dir = 8},/turf/open/floor/mineral/titanium,/area/ship/science)
"CL" = (/obj/machinery/door/airlock/command/glass,/obj/structure/fans/tiny/invisible,/obj/structure/cable{icon_state = "4-8"},/obj/machinery/atmospherics/pipe/simple/scrubbers/hidden/layer2{dir = 8},/turf/open/floor/mineral/titanium,/area/ship/medical)
"CZ" = (/obj/machinery/power/apc/auto_name/east,/obj/structure/cable{icon_state = "0-2"},/turf/open/floor/mineral/titanium/blue,/area/ship/medical)
"Dj" = (/obj/structure/cable{icon_state = "1-8"},/obj/structure/cable{icon_state = "1-4"},/obj/machinery/atmospherics/pipe/simple/scrubbers/hidden/layer2{dir = 5},/obj/machinery/light,/turf/open/floor/mineral/titanium,/area/ship/hallway/central)
"DB" = (/obj/machinery/power/apc/auto_name/west,/obj/structure/cable{icon_state = "0-4"},/obj/machinery/cryopod{dir = 4},/obj/machinery/computer/cryopod{pixel_y = 32},/turf/open/floor/mineral/titanium,/area/ship/hallway/central)
"DQ" = (/obj/item/clothing/suit/space/hardsuit/security/hos,/obj/item/clothing/suit/space/hardsuit/ert/sec,/obj/structure/table/reinforced,/obj/item/gun/ballistic/shotgun/riot,/obj/item/gun/ballistic/shotgun/riot,/obj/item/clothing/mask/gas/sechailer/swat,/obj/item/clothing/mask/gas/sechailer/swat,/turf/open/floor/mineral/plastitanium/red/brig,/area/ship/security)
"DY" = (/obj/structure/cable{icon_state = "2-8"},/obj/structure/closet/crate/freezer/blood,/turf/open/floor/mineral/titanium/blue,/area/ship/medical)
"Eg" = (/obj/structure/cable,/obj/machinery/power/apc/auto_name/south,/obj/structure/closet/secure_closet/captains,/turf/open/floor/mineral/plastitanium,/area/ship/bridge)
"Em" = (/obj/structure/cable{icon_state = "1-2"},/obj/machinery/atmospherics/components/unary/vent_scrubber/on/layer2{dir = 1},/turf/open/floor/mineral/plastitanium,/area/ship/bridge)
"EV" = (/obj/machinery/power/smes/engineering,/obj/structure/cable{icon_state = "0-4"},/obj/machinery/light{dir = 8},/turf/open/floor/mineral/titanium/yellow,/area/ship/engineering)
"Fm" = (/obj/machinery/atmospherics/pipe/simple/scrubbers/visible/layer2{dir = 8},/turf/closed/wall/mineral/titanium{color = "#2e2b30"},/area/ship/hallway/central)
"FN" = (/obj/machinery/atmospherics/pipe/simple/scrubbers/hidden/layer2{dir = 6},/obj/machinery/light{dir = 8},/turf/open/floor/mineral/plastitanium/red/brig,/area/ship/security)
"Gb" = (/obj/item/clothing/suit/space/hardsuit/ert,/obj/item/card/id/captains_spare,/obj/item/clothing/mask/gas/atmos/captain,/obj/item/gun/energy/laser/captain,/obj/structure/table/wood/fancy/black,/turf/open/floor/mineral/plastitanium,/area/ship/bridge)
"Gm" = (/obj/structure/cable{icon_state = "4-8"},/obj/machinery/atmospherics/pipe/manifold/scrubbers/visible/layer2,/turf/open/floor/mineral/titanium/blue,/area/ship/medical)
"Gy" = (/obj/structure/cable{icon_state = "1-2"},/obj/machinery/airalarm/directional/west,/obj/machinery/light{dir = 8},/turf/open/floor/mineral/plastitanium,/area/ship/bridge)
"GI" = (/turf/closed/wall/mineral/titanium{color = "#3a1f4d"},/area/ship/bridge)
"GK" = (/obj/machinery/computer/autopilot{dir = 8},/turf/open/floor/mineral/plastitanium,/area/ship/bridge)
"He" = (/obj/machinery/power/shuttle/engine/electric{dir = 4},/obj/structure/fans/tiny/invisible,/turf/closed/wall/mineral/titanium{color = "#2e2b30"},/area/ship/science)
"Ji" = (/obj/machinery/atmospherics/components/unary/vent_scrubber/on/layer2{dir = 4},/turf/open/floor/mineral/titanium,/area/ship/hallway/central)
"Kf" = (/obj/machinery/atmospherics/components/unary/vent_scrubber/on/layer2{dir = 1},/turf/open/floor/mineral/plastitanium/red/brig,/area/ship/security)
"Kw" = (/obj/machinery/atmospherics/components/unary/shuttle/heater{dir = 4},/obj/structure/fans/tiny/invisible,/turf/closed/wall/mineral/titanium{color = "#2e2b30"},/area/ship/engineering)
"Mz" = (/obj/machinery/atmospherics/components/unary/portables_connector{dir = 8},/obj/machinery/airalarm/directional/east,/turf/open/floor/mineral/titanium/yellow,/area/ship/engineering)
"NT" = (/turf/open/space/basic,/area/template_noop)
"Ov" = (/obj/machinery/atmospherics/components/unary/tank/toxins{dir = 8},/turf/open/floor/mineral/titanium/yellow,/area/ship/engineering)
"QG" = (/obj/machinery/atmospherics/pipe/simple/scrubbers/hidden/layer2{dir = 5},/turf/open/floor/mineral/titanium/blue,/area/ship/medical)
"Rc" = (/turf/open/floor/mineral/titanium,/area/ship/hallway/central)
"Rf" = (/turf/closed/wall/mineral/titanium{color = "#2e2b30"},/area/ship/science)
"Sc" = (/obj/structure/cable{icon_state = "1-2"},/obj/machinery/atmospherics/pipe/simple/scrubbers/hidden/layer2,/turf/open/floor/mineral/titanium/blue,/area/ship/medical)
"SF" = (/obj/structure/cable{icon_state = "1-2"},/obj/machinery/atmospherics/pipe/manifold/scrubbers/visible/layer2{dir = 8},/turf/open/floor/mineral/plastitanium/red/brig,/area/ship/security)
"SI" = (/obj/structure/cable{icon_state = "1-8"},/turf/open/floor/mineral/plastitanium/red/brig,/area/ship/security)
"Tc" = (/turf/closed/wall/mineral/titanium{color = "#3a1f4d"},/area/ship/security)
"Th" = (/obj/structure/cable{icon_state = "1-2"},/obj/structure/cable{icon_state = "2-8"},/obj/structure/cable{icon_state = "1-8"},/obj/machinery/atmospherics/pipe/simple/scrubbers/hidden/layer2,/turf/open/floor/mineral/titanium,/area/ship/hallway/central)
"Tk" = (/obj/machinery/door/airlock/engineering/glass,/obj/structure/fans/tiny/invisible,/obj/structure/cable{icon_state = "1-2"},/obj/machinery/atmospherics/pipe/simple/scrubbers/hidden/layer2{dir = 3},/turf/open/floor/mineral/titanium,/area/ship/science)
"Ui" = (/obj/machinery/atmospherics/pipe/simple/scrubbers/hidden/layer2{dir = 10},/turf/open/floor/mineral/plastitanium/red/brig,/area/ship/security)
"Uu" = (/obj/machinery/power/shuttle/engine/fueled/plasma{dir = 4},/obj/structure/fans/tiny/invisible,/turf/closed/wall/mineral/titanium{color = "#2e2b30"},/area/ship/engineering)
"Vq" = (/obj/machinery/power/apc/auto_name/east,/obj/structure/cable{icon_state = "0-8"},/obj/machinery/atmospherics/pipe/simple/scrubbers/hidden/layer2{dir = 9},/turf/open/floor/mineral/plastitanium/red/brig,/area/ship/security)
"Vr" = (/obj/machinery/autolathe,/turf/open/floor/mineral/titanium,/area/ship/science)
"Vw" = (/obj/machinery/door/airlock/security/glass,/obj/structure/fans/tiny/invisible,/obj/structure/cable{icon_state = "4-8"},/obj/machinery/atmospherics/pipe/simple/scrubbers/hidden/layer2{dir = 4},/turf/open/floor/mineral/titanium,/area/ship/hallway/central)
"VG" = (/obj/machinery/door/airlock/external/glass,/obj/structure/fans/tiny,/turf/open/floor/mineral/titanium,/area/ship/science)
"VV" = (/obj/machinery/door/airlock/medical/glass,/obj/structure/fans/tiny/invisible,/obj/structure/cable{icon_state = "1-2"},/obj/machinery/atmospherics/pipe/simple/scrubbers/hidden/layer2,/turf/open/floor/mineral/titanium,/area/ship/security)
"Ym" = (/obj/effect/spawner/structure/window/plasma/reinforced/plastitanium,/obj/structure/grille,/turf/open/floor/mineral/plastitanium,/area/ship/bridge)
"Zs" = (/obj/machinery/power/smes/shuttle/precharged{dir = 4},/obj/structure/fans/tiny/invisible,/turf/closed/wall/mineral/titanium{color = "#2e2b30"},/area/ship/hallway/central)
"Zv" = (/obj/structure/cable{icon_state = "4-8"},/obj/structure/cable{icon_state = "1-4"},/obj/structure/cable{icon_state = "1-8"},/obj/machinery/atmospherics/pipe/simple/scrubbers/hidden/layer2{dir = 10},/turf/open/floor/mineral/titanium/blue,/area/ship/medical)
"ZC" = (/obj/machinery/portable_atmospherics/canister/oxygen,/obj/machinery/portable_atmospherics/canister/oxygen,/obj/machinery/airalarm/directional/east,/turf/open/floor/mineral/titanium,/area/ship/hallway/central)
"ZM" = (/obj/machinery/computer/helm{dir = 8},/turf/open/floor/mineral/plastitanium,/area/ship/bridge)

(1,1,1) = {"
NTNTNTNTNTNTurcBVGurururururNTNTNTNTNT
NTurururururcBnGycALALALfQfQfQNTNTNTNT
NTNTNTNTNTNTHerOvNdLVrALpfiEfQfQurNTNT
NTNTNTNTNTcBRfALlNvZycALmJCZfQfQururNT
NTNTNTNTcBcBRfALkcpSjgCgGmZvDYfQGIurNT
urururururkTRfALALTkALALoTQGybCLnXGIur
NTNTNTurururpbdkEVxIMzdkbpgzScfQEmZMYm
NTNTNTNTNTNTUuKwgfeyOvdkTcTcVVTcGyGbYm
NTNTNTururcBpbdkgKfdpNdkDQrCpwTcqHGKYm
urururururzXFmhUhUBEeFeFFNaSVqTcEgGIur
NTNTNTNTcBcBfXeFDBThkAeFAiSIwBTcGIurNT
NTNTNTNTNTcBfXeFJiuWZCeFSFUileTcururNT
NTNTNTNTNTNTkuZswiDjhSVwgXKfdsTcurNTNT
NTurururururcBruRceFeFeFTcTcTcNTNTNTNT
NTNTNTNTNTNTurcBAsurururururNTNTNTNTNT
"}
