//MAP CONVERTED BY dmm2tgm.py THIS HEADER COMMENT PREVENTS RECONVERSION, DO NOT REMOVE
"a" = (
/turf/template_noop,
/area/template_noop)
"d" = (
/obj/machinery/computer/helm{
	dir = 8
	},
/turf/open/floor/mineral/plastitanium/red,
/area/ship/bridge)
"f" = (
/obj/effect/turf_decal/syndicateemblem/top/left,
/turf/open/floor/mineral/plastitanium/red,
/area/ship/bridge)
"h" = (
/obj/effect/turf_decal/syndicateemblem/bottom/middle,
/turf/open/floor/mineral/plastitanium/red,
/area/ship/bridge)
"i" = (
/obj/machinery/light,
/obj/machinery/power/smes/engineering,
/obj/structure/cable,
/turf/open/floor/mineral/plastitanium,
/area/ship/bridge)
"j" = (
/turf/closed/wall/mineral/plastitanium/nodiagonal,
/area/ship/bridge)
"k" = (
/obj/structure/closet/wall/orange{
	pixel_y = 32
	},
/obj/item/stack/sheet/mineral/uranium{
	amount = 10;
	pixel_x = -5;
	pixel_y = 2
	},
/obj/item/stack/sheet/mineral/uranium{
	amount = 10
	},
/turf/open/floor/mineral/plastitanium,
/area/ship/bridge)
"l" = (
/obj/machinery/power/smes/shuttle/precharged{
	dir = 4
	},
/obj/structure/cable{
	icon_state = "0-8"
	},
/obj/structure/window/plasma/reinforced{
	dir = 8
	},
/turf/open/floor/plating,
/area/ship/bridge)
"m" = (
/obj/machinery/vending/hydroseeds{
	all_items_free = 1;
	scan_id = 0
	},
/obj/machinery/light{
	dir = 1
	},
/obj/structure/sign/poster/contraband/random{
	pixel_y = 32
	},
/turf/open/floor/mineral/plastitanium/red,
/area/ship/bridge)
"n" = (
/obj/machinery/power/shuttle/engine/electric{
	dir = 4
	},
/obj/structure/cable{
	icon_state = "0-4"
	},
/turf/open/floor/plating,
/area/ship/bridge)
"o" = (
/obj/machinery/power/port_gen/pacman/uranium,
/obj/structure/cable{
	icon_state = "0-8"
	},
/turf/open/floor/mineral/plastitanium/red,
/area/ship/bridge)
"p" = (
/obj/structure/grille,
/obj/docking_port/mobile{
	callTime = 50;
	dir = 4;
	dwidth = 4;
	height = 5;
	ignitionTime = 25;
	launch_status = 0;
	name = "Syndicate Fighter";
	port_direction = 2;
	preferred_direction = 4;
	width = 9
	},
/obj/structure/window/plasma/reinforced/plastitanium,
/obj/machinery/door/poddoor/shutters{
	id = "SomePie101";
	name = "blast shutters"
	},
/turf/open/floor/mineral/plastitanium,
/area/ship/bridge)
"q" = (
/obj/machinery/power/apc/auto_name/west,
/obj/machinery/power/terminal{
	dir = 8
	},
/obj/machinery/turretid{
	desc = "Used to control the Inteceptor's automated defenses.";
	pixel_y = -25;
	req_access = list(150)
	},
/obj/structure/closet/crate,
/obj/item/circuitboard/machine/sleeper,
/obj/item/circuitboard/machine/sleeper,
/obj/item/circuitboard/machine/stasis,
/obj/item/circuitboard/machine/stasis,
/obj/effect/turf_decal/industrial/outline,
/obj/item/seeds/replicapod,
/obj/machinery/button{
	id = "SomePie101";
	pixel_y = -34
	},
/obj/item/tank/internals/oxygen/yellow,
/obj/item/tank/internals/oxygen/yellow,
/obj/item/tank/internals/oxygen/yellow,
/obj/item/tank/internals/oxygen/yellow,
/obj/item/tank/internals/oxygen/yellow,
/obj/structure/cable{
	icon_state = "0-4"
	},
/turf/open/floor/mineral/plastitanium,
/area/ship/bridge)
"s" = (
/turf/open/floor/mineral/plastitanium/red,
/area/ship/bridge)
"u" = (
/obj/machinery/autolathe,
/obj/machinery/light,
/turf/open/floor/mineral/plastitanium,
/area/ship/bridge)
"v" = (
/obj/structure/grille,
/obj/structure/window/plasma/reinforced/plastitanium,
/obj/machinery/door/poddoor/shutters{
	id = "SomePie101";
	name = "blast shutters"
	},
/turf/open/floor/plating,
/area/ship/bridge)
"w" = (
/obj/structure/cable{
	icon_state = "4-8"
	},
/turf/open/floor/mineral/plastitanium/red,
/area/ship/bridge)
"x" = (
/obj/machinery/porta_turret/centcom_shuttle/ballistic{
	dir = 5;
	name = "ship turret";
	on = 0
	},
/turf/closed/wall/mineral/plastitanium,
/area/ship/bridge)
"y" = (
/obj/machinery/vending/security/marine,
/obj/structure/sign/poster/official/cleanliness{
	pixel_y = -32
	},
/turf/open/floor/mineral/plastitanium,
/area/ship/bridge)
"B" = (
/obj/machinery/vending/medical{
	all_items_free = 1;
	scan_id = 0
	},
/obj/structure/sign/poster/contraband/random{
	pixel_y = 32
	},
/turf/open/floor/mineral/plastitanium,
/area/ship/bridge)
"C" = (
/obj/effect/turf_decal/industrial/outline,
/obj/structure/closet/crate,
/obj/item/stack/sheet/plasteel/fifty,
/obj/item/stack/cable_coil/blue,
/obj/item/stack/ore/bluespace_crystal,
/obj/item/stack/rods/ten,
/obj/item/stack/sheet/glass/fifty,
/obj/item/stack/sheet/metal/fifty,
/obj/item/stack/sheet/mineral/wood/fifty,
/obj/item/circuitboard/machine/hydroponics,
/obj/item/circuitboard/machine/hydroponics,
/obj/structure/cable{
	icon_state = "2-4"
	},
/obj/structure/cable{
	icon_state = "0-4"
	},
/obj/machinery/power/terminal{
	dir = 8
	},
/turf/open/floor/mineral/plastitanium,
/area/ship/bridge)
"D" = (
/obj/machinery/suit_storage_unit/syndicate{
	name = "captain's suit storage unit";
	storage_type = /obj/item/clothing/shoes/magboots/syndie;
	suit_type = /obj/item/clothing/suit/space/hardsuit/syndi/elite
	},
/turf/open/floor/mineral/plastitanium,
/area/ship/bridge)
"F" = (
/obj/machinery/vending/hydronutrients{
	all_items_free = 1;
	scan_id = 0
	},
/obj/machinery/light{
	dir = 1
	},
/turf/open/floor/mineral/plastitanium/red,
/area/ship/bridge)
"G" = (
/obj/effect/turf_decal/syndicateemblem/bottom/left,
/obj/structure/cable{
	icon_state = "1-2"
	},
/turf/open/floor/mineral/plastitanium/red,
/area/ship/bridge)
"H" = (
/obj/effect/turf_decal/syndicateemblem/top/middle,
/turf/open/floor/mineral/plastitanium/red,
/area/ship/bridge)
"J" = (
/obj/effect/turf_decal/syndicateemblem/bottom/right,
/turf/open/floor/mineral/plastitanium/red,
/area/ship/bridge)
"K" = (
/obj/machinery/suit_storage_unit/syndicate{
	storage_type = null
	},
/obj/machinery/light,
/obj/structure/cable{
	icon_state = "1-8"
	},
/turf/open/floor/mineral/plastitanium/red,
/area/ship/bridge)
"L" = (
/obj/effect/turf_decal/syndicateemblem/top/right,
/turf/open/floor/mineral/plastitanium/red,
/area/ship/bridge)
"O" = (
/obj/effect/turf_decal/syndicateemblem/middle/middle,
/obj/machinery/ore_silo,
/turf/open/floor/mineral/plastitanium/red,
/area/ship/bridge)
"P" = (
/obj/machinery/suit_storage_unit/syndicate{
	storage_type = null
	},
/obj/machinery/light,
/turf/open/floor/mineral/plastitanium/red,
/area/ship/bridge)
"Q" = (
/obj/structure/closet/wall/red{
	pixel_y = 32
	},
/obj/item/storage/toolbox/syndicate,
/obj/item/areaeditor/shuttle,
/obj/item/t_scanner/adv_mining_scanner,
/obj/item/t_scanner/adv_mining_scanner,
/obj/item/t_scanner/adv_mining_scanner,
/obj/item/syndie_crusher{
	pixel_x = 5;
	pixel_y = 6
	},
/obj/item/syndie_crusher{
	pixel_x = 5;
	pixel_y = 6
	},
/obj/item/syndie_crusher{
	pixel_x = 5;
	pixel_y = 6
	},
/obj/item/storage/backpack/duffelbag/syndie/c4{
	name = "bag of mining charges"
	},
/obj/item/melee/transforming/energy/sword/saber/red{
	name = "energy saber"
	},
/obj/item/melee/transforming/energy/sword/saber/red{
	name = "energy saber"
	},
/obj/item/melee/transforming/energy/sword/saber/red{
	name = "energy saber"
	},
/obj/item/gps/mining,
/obj/item/gps/mining,
/obj/item/gps/mining,
/obj/machinery/light{
	dir = 1
	},
/turf/open/floor/mineral/plastitanium,
/area/ship/bridge)
"T" = (
/obj/machinery/power/terminal{
	dir = 8
	},
/obj/structure/cable{
	icon_state = "0-4"
	},
/turf/open/floor/mineral/plastitanium,
/area/ship/bridge)
"U" = (
/turf/closed/wall/mineral/plastitanium,
/area/ship/bridge)
"V" = (
/obj/machinery/computer/cryopod{
	pixel_y = 26
	},
/obj/machinery/cryopod{
	dir = 1
	},
/obj/machinery/light{
	dir = 1
	},
/turf/open/floor/mineral/plastitanium,
/area/ship/bridge)
"W" = (
/obj/effect/turf_decal/syndicateemblem/middle/right,
/obj/machinery/holopad/emergency/command{
	name = "advanced holopad"
	},
/turf/open/floor/mineral/plastitanium/red,
/area/ship/bridge)
"X" = (
/obj/effect/turf_decal/syndicateemblem/middle/left,
/obj/structure/table/glass,
/obj/item/reagent_containers/food/snacks/syndicake{
	pixel_x = 1;
	pixel_y = 5
	},
/obj/item/reagent_containers/food/snacks/syndicake{
	pixel_x = -5;
	pixel_y = 2
	},
/obj/item/reagent_containers/food/snacks/syndicake,
/obj/structure/cable{
	icon_state = "2-8"
	},
/turf/open/floor/mineral/plastitanium/red,
/area/ship/bridge)
"Y" = (
/obj/structure/fans/tiny,
/obj/machinery/door/airlock/hatch{
	id_tag = "syndicatefighter"
	},
/turf/open/floor/mineral/plastitanium,
/area/ship/bridge)

(1,1,1) = {"
a
a
U
n
U
a
a
"}
(2,1,1) = {"
a
x
U
l
U
x
a
"}
(3,1,1) = {"
a
U
Q
C
i
U
a
"}
(4,1,1) = {"
U
j
k
w
T
j
U
"}
(5,1,1) = {"
j
D
s
w
o
q
j
"}
(6,1,1) = {"
v
m
f
X
G
K
v
"}
(7,1,1) = {"
Y
s
H
O
h
s
Y
"}
(8,1,1) = {"
v
F
L
W
J
P
v
"}
(9,1,1) = {"
j
B
s
s
s
y
j
"}
(10,1,1) = {"
U
j
V
d
u
j
U
"}
(11,1,1) = {"
a
x
v
p
v
x
a
"}
