//MAP CONVERTED BY dmm2tgm.py THIS HEADER COMMENT PREVENTS RECONVERSION, DO NOT REMOVE
"ae" = (
/obj/structure/window/fulltile,
/turf/open/floor/carpet/royalblack,
/area/ruin/powered{
	name = "\improper Dining Hall"
	})
"aF" = (
/obj/structure/table/wood/fancy/purple,
/obj/item/toy/plush/carpplushie/dehy_carp,
/obj/item/toy/plush/carpplushie/dehy_carp,
/obj/item/toy/plush/carpplushie/dehy_carp,
/obj/item/grenade/spawnergrenade/spesscarp,
/turf/open/floor/carpet/royalblack,
/area/ruin/powered{
	name = "\improper Dining Hall"
	})
"bE" = (
/obj/structure/table/wood/fancy,
/obj/item/reagent_containers/food/snacks/cubancarp,
/turf/open/floor/carpet/red,
/area/ruin/powered{
	name = "\improper Dining Hall"
	})
"dd" = (
/obj/structure/chair/wood/wings{
	dir = 5
	},
/obj/item/nullrod/carp,
/turf/open/floor/carpet/red,
/area/ruin/powered{
	name = "\improper Dining Hall"
	})
"ep" = (
/turf/closed/wall/mineral/wood,
/area/ruin/powered{
	name = "\improper Cold Storage"
	})
"gT" = (
/obj/structure/table/wood/fancy/purple,
/obj/item/storage/backpack/magspear_quiver,
/obj/item/throwing_star/magspear,
/obj/item/throwing_star/magspear,
/obj/item/throwing_star/magspear,
/obj/item/storage/backpack/magspear_quiver,
/turf/open/floor/carpet/royalblack,
/area/ruin/powered{
	name = "\improper Dining Hall"
	})
"hd" = (
/obj/structure/table/wood/fancy,
/obj/item/reagent_containers/food/snacks/burger/fish,
/turf/open/floor/carpet/red/airless,
/area/ruin/powered{
	name = "\improper Dining Hall"
	})
"hK" = (
/turf/open/floor/carpet/red_gold,
/area/ruin/powered{
	name = "\improper Dining Hall"
	})
"ib" = (
/turf/open/floor/wood,
/area/ruin/unpowered)
"jD" = (
/obj/machinery/door/airlock/wood/glass,
/turf/open/floor/carpet/royalblack,
/area/ruin/powered{
	name = "\improper Cold Storage"
	})
"mr" = (
/obj/structure/chair/wood/wings{
	dir = 4
	},
/turf/open/floor/carpet/red/airless,
/area/ruin/powered{
	name = "\improper Dining Hall"
	})
"nv" = (
/obj/machinery/atmospherics/pipe/heat_exchanging/simple{
	dir = 4
	},
/turf/open/floor/plasteel/kitchen_coldroom/freezerfloor,
/area/ruin/powered{
	name = "\improper Cold Storage"
	})
"oE" = (
/turf/open/floor/carpet/red,
/area/ruin/powered{
	name = "\improper Dining Hall"
	})
"sA" = (
/obj/structure/table/wood/fancy/purple,
/obj/item/pneumatic_cannon/speargun,
/obj/item/pneumatic_cannon/speargun,
/turf/open/floor/carpet/royalblack,
/area/ruin/powered{
	name = "\improper Dining Hall"
	})
"sL" = (
/turf/open/water/beach,
/area/ruin/unpowered)
"tX" = (
/obj/machinery/porta_turret{
	faction = list("turret", "beach")
	},
/turf/closed/wall/mineral/wood,
/area/ruin/powered{
	name = "\improper Cold Storage"
	})
"ut" = (
/turf/open/floor/carpet/royalblack,
/area/ruin/powered{
	name = "\improper Dining Hall"
	})
"uD" = (
/turf/open/floor/carpet/red/airless,
/area/ruin/powered{
	name = "\improper Dining Hall"
	})
"uZ" = (
/obj/structure/table/wood/fancy,
/obj/item/reagent_containers/food/snacks/fishandchips,
/turf/open/floor/carpet/red,
/area/ruin/powered{
	name = "\improper Dining Hall"
	})
"vc" = (
/obj/structure/table/wood/fancy,
/obj/item/reagent_containers/food/snacks/meat/slab/human/mutant/squid,
/turf/open/floor/carpet/red/airless,
/area/ruin/powered{
	name = "\improper Dining Hall"
	})
"vL" = (
/obj/structure/kitchenspike,
/obj/machinery/atmospherics/pipe/heat_exchanging/simple{
	dir = 4
	},
/turf/open/floor/plasteel/kitchen_coldroom/freezerfloor,
/area/ruin/powered{
	name = "\improper Cold Storage"
	})
"wH" = (
/obj/structure/table/wood/fancy,
/obj/item/reagent_containers/food/drinks/soda_cans/cola,
/turf/open/floor/carpet/red,
/area/ruin/powered{
	name = "\improper Dining Hall"
	})
"wN" = (
/obj/structure/destructible/tribal_torch,
/turf/open/floor/plating/beach/sand/lit,
/area/ruin/unpowered)
"xw" = (
/mob/living/simple_animal/hostile/carp/megacarp/beach,
/turf/open/water/beach,
/area/ruin/unpowered)
"Ch" = (
/obj/structure/table/wood/fancy,
/obj/structure/table/wood/fancy,
/turf/open/floor/carpet/red,
/area/ruin/powered{
	name = "\improper Dining Hall"
	})
"Ds" = (
/obj/structure/table/wood/fancy,
/obj/item/storage/fancy/cigarettes/cigars/havana,
/turf/open/floor/carpet/red/airless,
/area/ruin/powered{
	name = "\improper Dining Hall"
	})
"DM" = (
/obj/structure/table/wood/fancy,
/obj/item/reagent_containers/food/drinks/soda_cans/cola,
/turf/open/floor/carpet/red/airless,
/area/ruin/powered{
	name = "\improper Dining Hall"
	})
"DO" = (
/obj/structure/table/wood/fancy,
/obj/item/reagent_containers/food/snacks/fishfry,
/turf/open/floor/carpet/red/airless,
/area/ruin/powered{
	name = "\improper Dining Hall"
	})
"Eq" = (
/obj/machinery/door/airlock/wood/glass,
/turf/open/floor/wood,
/area/ruin/powered{
	name = "\improper Dining Hall"
	})
"FG" = (
/turf/open/floor/plating/beach/sand/lit,
/area/ruin/unpowered)
"FK" = (
/obj/machinery/light/dim,
/turf/open/floor/carpet/royalblack,
/area/ruin/powered{
	name = "\improper Dining Hall"
	})
"Iv" = (
/obj/structure/barricade/wooden,
/turf/open/floor/wood,
/area/ruin/unpowered)
"Ko" = (
/turf/closed/wall/mineral/wood,
/area/ruin/powered{
	name = "\improper Dining Hall"
	})
"Kq" = (
/obj/machinery/light/dim,
/turf/open/floor/plasteel/kitchen_coldroom/freezerfloor,
/area/ruin/powered{
	name = "\improper Cold Storage"
	})
"KY" = (
/obj/structure/table/wood/fancy,
/turf/open/floor/carpet/red/airless,
/area/ruin/powered{
	name = "\improper Dining Hall"
	})
"Ly" = (
/obj/structure/stairs/north,
/turf/open/floor/wood,
/area/ruin/unpowered)
"Mn" = (
/obj/structure/sink,
/turf/closed/wall/mineral/wood,
/area/ruin/powered{
	name = "\improper Cold Storage"
	})
"Ok" = (
/obj/machinery/atmospherics/components/unary/thermomachine/freezer/on/coldroom,
/turf/open/floor/plasteel/kitchen_coldroom/freezerfloor,
/area/ruin/powered{
	name = "\improper Cold Storage"
	})
"Os" = (
/obj/structure/table/wood/fancy,
/obj/item/guardiancreator/carp,
/turf/open/floor/carpet/red/airless,
/area/ruin/powered{
	name = "\improper Dining Hall"
	})
"OE" = (
/obj/structure/table/rolling,
/obj/item/kitchen/knife/butcher,
/turf/open/floor/plasteel/kitchen_coldroom/freezerfloor,
/area/ruin/powered{
	name = "\improper Cold Storage"
	})
"PB" = (
/obj/structure/kitchenspike,
/turf/open/floor/plasteel/kitchen_coldroom/freezerfloor,
/area/ruin/powered{
	name = "\improper Cold Storage"
	})
"Qi" = (
/obj/structure/closet/secure_closet/freezer/fridge,
/turf/open/floor/plasteel/kitchen_coldroom/freezerfloor,
/area/ruin/powered{
	name = "\improper Cold Storage"
	})
"QO" = (
/turf/open/floor/plasteel/kitchen_coldroom/freezerfloor,
/area/ruin/powered{
	name = "\improper Cold Storage"
	})
"Ta" = (
/obj/structure/table/rolling,
/obj/machinery/microwave,
/turf/open/floor/plasteel/kitchen_coldroom/freezerfloor,
/area/ruin/powered{
	name = "\improper Cold Storage"
	})
"Xp" = (
/obj/structure/table/rolling,
/obj/item/clothing/suit/space/hardsuit/carp,
/turf/open/floor/plasteel/kitchen_coldroom/freezerfloor,
/area/ruin/powered{
	name = "\improper Cold Storage"
	})
"Xt" = (
/obj/machinery/deepfryer,
/turf/open/floor/plasteel/kitchen_coldroom/freezerfloor,
/area/ruin/powered{
	name = "\improper Cold Storage"
	})
"YJ" = (
/obj/structure/closet/crate/freezer,
/turf/open/floor/plasteel/kitchen_coldroom/freezerfloor,
/area/ruin/powered{
	name = "\improper Cold Storage"
	})
"ZG" = (
/obj/machinery/atmospherics/pipe/heat_exchanging/junction,
/turf/open/floor/plasteel/kitchen_coldroom/freezerfloor,
/area/ruin/powered{
	name = "\improper Cold Storage"
	})

(1,1,1) = {"
Ko
Ko
Ko
Ko
Ko
Ko
Ko
Ko
Ko
FG
FG
xw
sL
sL
"}
(2,1,1) = {"
ae
ut
ut
aF
gT
sA
ut
ut
Ko
FG
FG
FG
FG
FG
"}
(3,1,1) = {"
ae
ut
ut
ut
ut
ut
ut
FK
ep
ep
ep
ep
ep
tX
"}
(4,1,1) = {"
ae
ut
hK
hK
hK
hK
hK
ut
ep
Ok
ZG
QO
QO
ep
"}
(5,1,1) = {"
ae
ut
hK
oE
oE
oE
hK
ut
jD
QO
QO
PB
Kq
ep
"}
(6,1,1) = {"
ae
ut
hK
oE
mr
uD
hK
ut
jD
QO
QO
nv
QO
ep
"}
(7,1,1) = {"
ae
ut
hK
uZ
hd
vc
hK
ut
Mn
QO
QO
vL
QO
ep
"}
(8,1,1) = {"
ae
ut
hK
wH
KY
Ds
hK
ut
ep
OE
QO
QO
QO
ep
"}
(9,1,1) = {"
ae
ut
hK
Ch
KY
DM
hK
FK
ep
Qi
QO
vL
QO
ep
"}
(10,1,1) = {"
ae
ut
hK
bE
Os
DO
hK
ut
ep
Ta
QO
QO
QO
ep
"}
(11,1,1) = {"
ae
ut
hK
oE
oE
oE
hK
ut
ep
Xp
QO
vL
QO
ep
"}
(12,1,1) = {"
ae
ut
hK
dd
oE
oE
hK
ut
ep
Xt
QO
nv
Kq
ep
"}
(13,1,1) = {"
ae
ut
hK
hK
hK
hK
hK
ut
ep
YJ
QO
QO
QO
ep
"}
(14,1,1) = {"
ae
ut
ut
ut
ut
ut
ut
FK
ep
ep
ep
ep
ep
tX
"}
(15,1,1) = {"
ae
ut
ut
ut
ut
ut
ut
ut
Ko
FG
FG
FG
FG
FG
"}
(16,1,1) = {"
Ko
Ko
Ko
Ko
Ko
Eq
Ko
Ko
Ko
Iv
wN
FG
sL
sL
"}
(17,1,1) = {"
ib
ib
ib
ib
Iv
Ly
Ly
Ly
Ly
Ly
Ly
FG
xw
sL
"}
(18,1,1) = {"
ib
ib
ib
ib
Iv
Iv
Iv
Iv
Iv
Iv
wN
FG
sL
sL
"}
