//MAP CONVERTED BY dmm2tgm.py THIS HEADER COMMENT PREVENTS RECONVERSION, DO NOT REMOVE
"bn" = (
/obj/structure/window/reinforced/spawner,
/turf/open/floor/carpet/red_gold,
/area/ruin/space)
"by" = (
/obj/structure/rack,
/obj/item/canvas/twentythreeXtwentythree,
/obj/item/canvas/twentythreeXnineteen,
/obj/item/canvas/twentythreeXnineteen,
/obj/item/canvas/nineteenXnineteen,
/obj/item/storage/crayons,
/obj/item/stack/cable_coil/red,
/obj/item/stack/cable_coil/red,
/obj/item/stack/cable_coil/red,
/turf/open/floor/carpet/red_gold,
/area/ruin/space)
"bQ" = (
/mob/living/simple_animal/hostile/faithless,
/turf/open/floor/plating/rust,
/area/ruin/space)
"dX" = (
/obj/structure/window/reinforced/spawner/east,
/obj/effect/decal/cleanable/glass,
/turf/open/floor/carpet/red_gold,
/area/ruin/space)
"fn" = (
/obj/effect/decal/cleanable/blood/tracks,
/turf/open/floor/carpet/red_gold,
/area/ruin/space)
"gS" = (
/obj/structure/window/reinforced/spawner/west,
/obj/structure/window/reinforced/spawner/north,
/turf/open/floor/carpet/red_gold,
/area/ruin/space)
"hg" = (
/obj/structure/bookcase/random,
/obj/structure/bookcase/random,
/turf/open/floor/plating,
/area/ruin/space)
"lc" = (
/obj/effect/decal/cleanable/blood/gibs/limb,
/obj/item/shard,
/obj/effect/decal/cleanable/glass,
/obj/effect/decal/cleanable/blood/drip,
/turf/open/floor/carpet/red_gold,
/area/ruin/space)
"lH" = (
/obj/item/shard,
/turf/open/floor/plating/rust,
/area/ruin/space)
"mL" = (
/obj/effect/decal/cleanable/blood/drip,
/turf/open/floor/carpet/red_gold,
/area/ruin/space)
"nc" = (
/obj/effect/decal/cleanable/blood,
/obj/effect/decal/cleanable/glass,
/turf/open/floor/carpet/red_gold,
/area/ruin/space)
"nz" = (
/turf/open/floor/plating,
/area/ruin/space)
"oz" = (
/obj/effect/decal/cleanable/blood/gibs/core,
/obj/effect/decal/cleanable/blood/drip,
/obj/effect/decal/cleanable/blood/drip,
/turf/open/floor/plating/rust,
/area/ruin/space)
"ql" = (
/obj/effect/mob_spawn/human/corpse/assistant,
/turf/open/floor/carpet/red_gold,
/area/ruin/space)
"qU" = (
/obj/structure/lattice,
/turf/open/space/basic,
/area/ruin/space)
"rx" = (
/obj/structure/bookcase/random,
/turf/open/floor/carpet/red_gold,
/area/ruin/space)
"sU" = (
/obj/item/bikehorn/golden,
/obj/effect/decal/cleanable/blood/footprints{
	dir = 1
	},
/turf/open/floor/plating,
/area/ruin/space)
"tu" = (
/turf/closed/wall/mineral/iron{
	color = null
	},
/area/ruin/space)
"wb" = (
/obj/item/wallframe/painting,
/turf/closed/wall/mineral/iron{
	color = null
	},
/area/ruin/space)
"xn" = (
/obj/effect/decal/cleanable/blood/gibs/core,
/turf/open/floor/carpet/red_gold,
/area/ruin/space)
"xU" = (
/obj/effect/decal/cleanable/glass,
/turf/open/floor/carpet/red_gold,
/area/ruin/space)
"zn" = (
/turf/open/floor/plating/rust,
/area/ruin/space)
"zF" = (
/obj/effect/decal/cleanable/glass,
/turf/open/floor/plating/rust,
/area/ruin/space)
"zS" = (
/obj/structure/window/reinforced/spawner,
/obj/effect/decal/cleanable/glass,
/turf/open/floor/carpet/red_gold,
/area/ruin/space)
"Bl" = (
/obj/effect/decal/cleanable/blood,
/obj/effect/decal/cleanable/blood/tracks{
	dir = 9
	},
/turf/open/floor/carpet/red_gold,
/area/ruin/space)
"Cn" = (
/obj/effect/decal/cleanable/blood/gibs/old,
/turf/open/floor/plating/rust,
/area/ruin/space)
"CR" = (
/obj/effect/mob_spawn/human/corpse/wizard,
/turf/open/floor/plating,
/area/ruin/space)
"DK" = (
/obj/item/shard,
/turf/open/floor/plating,
/area/ruin/space)
"Ev" = (
/obj/effect/decal/cleanable/blood/tracks,
/obj/effect/decal/cleanable/blood/gibs/up,
/turf/open/floor/carpet/red_gold,
/area/ruin/space)
"EP" = (
/obj/effect/decal/cleanable/blood/splatter,
/turf/open/floor/carpet/red_gold,
/area/ruin/space)
"FR" = (
/obj/effect/decal/cleanable/blood,
/obj/effect/decal/cleanable/blood/drip,
/turf/open/floor/carpet/red_gold,
/area/ruin/space)
"Gk" = (
/obj/effect/decal/cleanable/blood/gibs/limb,
/obj/effect/decal/cleanable/blood/gibs/core,
/turf/open/floor/plating/rust,
/area/ruin/space)
"Gu" = (
/obj/effect/decal/cleanable/blood/tracks,
/obj/effect/decal/cleanable/blood/innards,
/turf/open/floor/carpet/red_gold,
/area/ruin/space)
"HK" = (
/obj/structure/lattice,
/obj/structure/lattice,
/turf/open/space/basic,
/area/ruin/space)
"HV" = (
/obj/item/book/granter/spell/random,
/turf/open/floor/carpet/red_gold,
/area/ruin/space)
"Ip" = (
/obj/effect/decal/cleanable/blood,
/turf/open/floor/plating/rust,
/area/ruin/space)
"IA" = (
/obj/effect/mob_spawn/human/clown/corpse,
/obj/item/toy/crayon/spraycan/lubecan,
/turf/open/floor/plating/rust,
/area/ruin/space)
"JD" = (
/obj/structure/window/reinforced/spawner,
/obj/structure/window/reinforced/spawner/west,
/obj/effect/decal/cleanable/glass,
/turf/open/floor/plating/rust,
/area/ruin/space)
"LN" = (
/obj/item/shard,
/obj/effect/decal/cleanable/blood/drip,
/turf/open/floor/carpet/red_gold,
/area/ruin/space)
"Mc" = (
/obj/effect/decal/cleanable/blood/drip,
/turf/open/floor/plating,
/area/ruin/space)
"Mi" = (
/obj/effect/decal/cleanable/blood/footprints{
	dir = 1
	},
/obj/effect/decal/cleanable/blood/drip,
/turf/open/floor/carpet/red_gold,
/area/ruin/space)
"Mt" = (
/obj/machinery/door/airlock/glass_large,
/obj/effect/decal/cleanable/blood/footprints{
	dir = 1
	},
/turf/open/floor/plating/rust,
/area/ruin/space)
"Nl" = (
/turf/template_noop,
/area/template_noop)
"NH" = (
/obj/structure/bookcase/random,
/turf/open/floor/plating,
/area/ruin/space)
"Os" = (
/mob/living/simple_animal/hostile/faithless,
/turf/open/floor/carpet/red_gold,
/area/ruin/space)
"PG" = (
/obj/structure/statue/sandstone/venus,
/obj/effect/mob_spawn/human/corpse/assistant,
/turf/open/floor/carpet/red_gold,
/area/ruin/space)
"Qj" = (
/obj/effect/decal/cleanable/blood/gibs/old,
/obj/effect/decal/cleanable/glass,
/turf/open/floor/carpet/red_gold,
/area/ruin/space)
"QC" = (
/obj/effect/decal/cleanable/blood/tracks{
	dir = 6
	},
/obj/effect/decal/cleanable/blood/gibs/torso,
/obj/effect/decal/cleanable/blood/innards,
/turf/open/floor/plating/rust,
/area/ruin/space)
"Rl" = (
/obj/structure/bookcase/random,
/obj/item/book/granter/spell/random,
/turf/open/floor/carpet/red_gold,
/area/ruin/space)
"RE" = (
/obj/effect/decal/cleanable/blood/gibs/core,
/obj/effect/decal/cleanable/glass,
/obj/effect/decal/cleanable/blood/drip,
/turf/open/floor/carpet/red_gold,
/area/ruin/space)
"TK" = (
/obj/item/shard,
/turf/open/floor/carpet/red_gold,
/area/ruin/space)
"TP" = (
/obj/effect/decal/cleanable/blood/drip,
/turf/open/floor/plating/rust,
/area/ruin/space)
"Vj" = (
/mob/living/simple_animal/hostile/statue,
/turf/open/floor/plating/rust,
/area/ruin/space)
"WG" = (
/obj/effect/mob_spawn/human/corpse/assistant,
/turf/open/floor/plating/rust,
/area/ruin/space)
"Xb" = (
/turf/open/floor/carpet/red_gold,
/area/ruin/space)
"Xd" = (
/obj/structure/rack,
/obj/item/canvas/twentythreeXtwentythree,
/obj/item/canvas/twentythreeXtwentythree,
/obj/item/canvas/nineteenXnineteen,
/obj/item/canvas/nineteenXnineteen,
/obj/item/storage/crayons,
/obj/item/storage/crayons,
/obj/item/stack/cable_coil/red,
/turf/open/floor/carpet/red_gold,
/area/ruin/space)
"Za" = (
/obj/structure/lattice,
/turf/open/space,
/area/ruin/space)

(1,1,1) = {"
Nl
qU
Nl
Nl
Nl
Nl
Nl
qU
Nl
Nl
Nl
Nl
qU
Nl
Nl
Nl
Nl
Nl
Nl
Nl
"}
(2,1,1) = {"
Nl
Nl
qU
Nl
Nl
qU
Nl
qU
qU
HK
Za
Nl
qU
Nl
Nl
Nl
Nl
Nl
Nl
Nl
"}
(3,1,1) = {"
qU
qU
tu
tu
tu
nz
zn
lH
Nl
Za
Nl
tu
tu
tu
tu
Nl
qU
qU
Nl
qU
"}
(4,1,1) = {"
Nl
Nl
wb
Xb
Xb
Xb
zF
qU
Za
Za
Nl
zn
Xb
Xb
zn
zn
Nl
qU
qU
Nl
"}
(5,1,1) = {"
Nl
qU
tu
Xb
Xb
Xb
Xb
lH
zn
dX
Za
Xb
Xb
Os
Xb
Nl
nz
zn
qU
qU
"}
(6,1,1) = {"
Nl
Nl
tu
tu
tu
tu
ql
TP
nc
DK
nz
Gk
Xb
TP
nz
Xb
Nl
qU
qU
qU
"}
(7,1,1) = {"
Nl
Nl
hg
zn
rx
wb
Xb
xU
mL
Bl
Gu
fn
Qj
zn
zn
nz
zn
nz
Nl
Nl
"}
(8,1,1) = {"
qU
Nl
zn
HV
NH
tu
tu
tu
Ev
QC
EP
tu
lH
WG
Ip
Xb
Xb
tu
Nl
qU
"}
(9,1,1) = {"
Nl
qU
nz
Vj
NH
tu
by
wb
Os
TP
EP
tu
zn
Xb
TP
Xb
zn
tu
qU
qU
"}
(10,1,1) = {"
Nl
qU
qU
CR
sU
Mt
Mi
Mt
oz
Xb
TP
wb
Xb
zn
Xb
zn
zn
zn
qU
Nl
"}
(11,1,1) = {"
Nl
Nl
nz
qU
IA
Xb
mL
Xb
Xb
zn
TP
wb
Xb
EP
Xb
TP
TP
tu
Nl
qU
"}
(12,1,1) = {"
Nl
qU
zn
Vj
rx
tu
Xd
tu
Os
zn
TP
tu
Xb
Cn
bQ
mL
Mc
tu
qU
qU
"}
(13,1,1) = {"
Nl
qU
zn
zn
NH
tu
tu
tu
Xb
zn
Xb
tu
RE
Cn
zn
Xb
Xb
tu
Nl
Nl
"}
(14,1,1) = {"
Nl
qU
zn
zn
Rl
wb
Xb
zn
zn
xU
LN
xU
Xb
zn
zn
Xb
Xb
tu
Nl
Nl
"}
(15,1,1) = {"
qU
Nl
tu
tu
tu
tu
Xb
Xb
gS
Ip
xU
JD
zn
zn
Xb
FR
nz
qU
qU
Nl
"}
(16,1,1) = {"
Nl
Nl
tu
Xb
zn
zn
zn
xU
lH
nz
PG
zS
xn
Xb
zn
nz
Xb
qU
Nl
Nl
"}
(17,1,1) = {"
Nl
Nl
wb
Xb
Xb
Xb
zn
TK
qU
qU
xU
bn
Xb
lc
zn
Nl
qU
qU
qU
Nl
"}
(18,1,1) = {"
Nl
Nl
tu
tu
tu
tu
tu
tu
nz
qU
tu
tu
tu
tu
Nl
qU
qU
Nl
qU
Nl
"}
(19,1,1) = {"
Nl
Nl
HK
qU
qU
qU
qU
qU
qU
qU
Nl
qU
Nl
Nl
qU
qU
qU
Nl
Nl
Nl
"}
(20,1,1) = {"
Nl
Nl
Nl
HK
qU
Nl
Nl
Nl
Nl
Nl
qU
Nl
qU
Nl
Nl
Nl
Nl
Nl
Nl
Nl
"}
