//MAP CONVERTED BY dmm2tgm.py THIS HEADER COMMENT PREVENTS RECONVERSION, DO NOT REMOVE
"aa" = (
/obj/effect/forcefield/mime/advanced,
/turf/open/floor/plasteel/tech,
/area/ruin/powered/clownplanet)
"cN" = (
/obj/machinery/light/small/broken,
/turf/open/floor/plasteel/white,
/area/ruin/powered/clownplanet)
"cO" = (
/obj/item/reagent_containers/food/drinks/bottle/bottleofnothing,
/turf/open/floor/plasteel/tech,
/area/ruin/powered/clownplanet)
"dc" = (
/obj/item/melee/transforming/energy/sword/bananium,
/obj/effect/decal/cleanable/blood/gibs/limb,
/turf/open/floor/mineral/bananium/airless,
/area/awaymission)
"fa" = (
/turf/open/floor/plasteel/tech,
/area/ruin/powered/clownplanet)
"fe" = (
/obj/machinery/washing_machine,
/turf/open/floor/plasteel/tech,
/area/ruin/powered/clownplanet)
"fH" = (
/obj/effect/turf_decal/radiation/white,
/turf/closed/indestructible/reinforced,
/area/ruin/powered/clownplanet)
"fZ" = (
/obj/effect/turf_decal/box,
/obj/effect/spawner/lootdrop/maintenance,
/obj/structure/closet/crate,
/turf/open/floor/plasteel/tech,
/area/ruin/powered/clownplanet)
"gh" = (
/obj/effect/decal/cleanable/blood/footprints,
/obj/machinery/door/airlock/silver/glass,
/turf/open/floor/plasteel/white,
/area/ruin/powered/clownplanet)
"gj" = (
/obj/effect/decal/cleanable/blood/tracks,
/turf/open/floor/plasteel/tech,
/area/ruin/powered/clownplanet)
"he" = (
/obj/structure/table/reinforced,
/obj/item/pen/sleepy,
/obj/machinery/light/small{
	dir = 1
	},
/turf/open/floor/plasteel/tech/grid,
/area/ruin/powered/clownplanet)
"ht" = (
/obj/item/stack/sheet/mineral/bananium,
/obj/effect/decal/cleanable/blood/gibs,
/obj/effect/decal/cleanable/blood,
/turf/open/floor/mineral/bananium/airless,
/area/awaymission)
"hZ" = (
/turf/open/floor/plasteel/tech/grid,
/area/ruin/powered/clownplanet)
"ib" = (
/obj/effect/forcefield{
	alpha = 0;
	desc = "An invisible wall.";
	name = "invisible wall";
	timeleft = 0
	},
/turf/open/floor/plasteel/tech,
/area/ruin/powered/clownplanet)
"iG" = (
/obj/structure/plasticflaps/opaque,
/obj/machinery/conveyor,
/turf/open/floor/plasteel/white,
/area/ruin/powered/clownplanet)
"ji" = (
/obj/item/ammo_casing/c10mm{
	dir = 8
	},
/turf/open/floor/plating/asteroid/airless,
/area/awaymission)
"ki" = (
/obj/effect/decal/cleanable/blood/gibs/core,
/obj/item/implanter/sad_trombone,
/turf/open/floor/mineral/bananium,
/area/awaymission)
"lo" = (
/turf/open/floor/plasteel/white,
/area/awaymission)
"mg" = (
/obj/item/clothing/mask/gas/clown_hat,
/obj/effect/decal/cleanable/blood/gibs/up,
/turf/open/floor/mineral/bananium/airless,
/area/awaymission)
"mD" = (
/obj/machinery/door/poddoor/shuttledock,
/turf/open/floor/plasteel/white,
/area/ruin/powered/clownplanet)
"no" = (
/obj/machinery/conveyor,
/turf/open/floor/plasteel/tech,
/area/ruin/powered/clownplanet)
"nP" = (
/mob/living/simple_animal/hostile/illusion{
	atmos_requirements = list("min_oxy" = 0, "max_oxy" = 0, "min_tox" = 0, "max_tox" = 0, "min_co2" = 0, "max_co2" = 0, "min_n2" = 0, "max_n2" = 0);
	dir = 4;
	health = 200;
	maxHealth = 200;
	melee_damage_lower = 20;
	melee_damage_upper = 35
	},
/turf/open/floor/plasteel/white,
/area/ruin/powered/clownplanet)
"nT" = (
/obj/item/clothing/mask/gas/clown_hat,
/obj/effect/decal/cleanable/blood/gibs/down,
/turf/open/floor/plasteel/tech,
/area/ruin/powered/clownplanet)
"pc" = (
/obj/item/clothing/shoes/sneakers/mime,
/obj/item/clothing/under/rank/civilian/mime,
/obj/item/clothing/mask/gas/mime,
/obj/structure/closet,
/obj/item/clothing/head/beret/archaic,
/turf/open/floor/plasteel/white,
/area/ruin/powered/clownplanet)
"ps" = (
/obj/effect/mine/gas/water_vapor{
	alpha = 60
	},
/turf/open/floor/plasteel/tech,
/area/ruin/powered/clownplanet)
"pM" = (
/obj/item/toy/figure/mime,
/turf/open/floor/plasteel/tech,
/area/ruin/powered/clownplanet)
"qB" = (
/obj/effect/mine/stun{
	alpha = 60
	},
/turf/open/floor/plasteel/tech,
/area/ruin/powered/clownplanet)
"qN" = (
/turf/closed/mineral/random/asteroid,
/area/awaymission)
"sp" = (
/obj/structure/shuttle/engine/propulsion/right{
	dir = 8
	},
/turf/open/floor/plating/asteroid/airless,
/area/awaymission)
"tN" = (
/obj/effect/decal/cleanable/blood/footprints,
/turf/open/floor/plasteel/white,
/area/ruin/powered/clownplanet)
"tU" = (
/obj/effect/decal/cleanable/blood/drip,
/turf/open/floor/plasteel/white,
/area/ruin/powered/clownplanet)
"um" = (
/obj/effect/decal/cleanable/blood/tracks,
/obj/structure/door_assembly/door_assembly_silver{
	anchored = 1
	},
/turf/open/floor/plasteel/white,
/area/ruin/powered/clownplanet)
"uK" = (
/obj/effect/turf_decal/box,
/obj/item/research_notes/loot/medium,
/obj/effect/spawner/lootdrop/glowstick,
/obj/structure/closet/crate,
/turf/open/floor/plasteel/white,
/area/ruin/powered/clownplanet)
"vb" = (
/obj/effect/decal/cleanable/blood/splatter,
/turf/open/floor/mineral/bananium/airless,
/area/awaymission)
"vz" = (
/turf/closed/indestructible/reinforced,
/area/ruin/powered/clownplanet)
"wh" = (
/obj/effect/mine/shrapnel/sting{
	alpha = 60
	},
/turf/open/floor/plasteel/white,
/area/ruin/powered/clownplanet)
"wP" = (
/turf/open/floor/plasteel/tech,
/area/awaymission)
"wT" = (
/obj/structure/table/reinforced,
/obj/item/toy/crayon/spraycan/mimecan,
/obj/machinery/light/small,
/turf/open/floor/plasteel/tech/grid,
/area/ruin/powered/clownplanet)
"ya" = (
/obj/effect/turf_decal/box,
/obj/effect/spawner/lootdrop/costume,
/obj/effect/spawner/lootdrop/costume,
/obj/structure/closet/crate,
/turf/open/floor/plasteel/tech,
/area/ruin/powered/clownplanet)
"yg" = (
/obj/machinery/door/airlock/silver,
/turf/open/floor/plasteel/white,
/area/ruin/powered/clownplanet)
"yy" = (
/obj/item/phone{
	desc = "It has H.O.N.K. written on it";
	dye_color = null
	},
/obj/item/veilrender/honkrender,
/obj/structure/closet{
	opened = 1
	},
/turf/open/floor/plasteel/white,
/area/ruin/powered/clownplanet)
"zx" = (
/obj/structure/table/wood/fancy/black,
/obj/item/kitchen/knife/hunting,
/obj/item/keycard/office{
	desc = "A weirdly shaped keycard... Maybe it can be used somewhere.";
	name = "strange keycard"
	},
/turf/open/floor/plasteel/white,
/area/ruin/powered/clownplanet)
"Az" = (
/obj/item/cartridge/virus/mime,
/obj/machinery/conveyor,
/turf/open/floor/plasteel/white,
/area/ruin/powered/clownplanet)
"AL" = (
/obj/effect/forcefield{
	alpha = 0;
	desc = "An invisible wall.";
	name = "invisible wall";
	timeleft = 0
	},
/turf/open/floor/plasteel/white,
/area/ruin/powered/clownplanet)
"Bz" = (
/obj/machinery/door/poddoor/shuttledock,
/turf/open/floor/plasteel/tech,
/area/ruin/powered/clownplanet)
"BR" = (
/obj/effect/turf_decal/box,
/obj/item/research_notes/loot/medium,
/obj/effect/spawner/lootdrop/costume,
/obj/structure/closet/crate,
/turf/open/floor/plasteel/tech,
/area/ruin/powered/clownplanet)
"Cd" = (
/obj/effect/forcefield/mime/advanced,
/turf/open/floor/plasteel/white,
/area/ruin/powered/clownplanet)
"Ch" = (
/obj/machinery/conveyor,
/obj/item/dnainjector/mutemut,
/turf/open/floor/plasteel/white,
/area/ruin/powered/clownplanet)
"CA" = (
/obj/effect/mine/shrapnel/human_only{
	alpha = 60
	},
/mob/living/simple_animal/hostile/illusion{
	atmos_requirements = list("min_oxy" = 0, "max_oxy" = 0, "min_tox" = 0, "max_tox" = 0, "min_co2" = 0, "max_co2" = 0, "min_n2" = 0, "max_n2" = 0);
	health = 200;
	maxHealth = 200;
	melee_damage_lower = 20;
	melee_damage_upper = 35
	},
/turf/open/floor/plasteel/white,
/area/ruin/powered/clownplanet)
"Dn" = (
/obj/item/clothing/mask/gas/mime,
/obj/machinery/conveyor,
/turf/open/floor/plasteel/tech,
/area/ruin/powered/clownplanet)
"Dp" = (
/obj/effect/turf_decal/box,
/obj/effect/spawner/lootdrop/gloves,
/obj/structure/closet/crate,
/turf/open/floor/plasteel/tech,
/area/ruin/powered/clownplanet)
"Fj" = (
/obj/structure/table,
/obj/item/gun/ballistic/automatic/pistol,
/turf/open/floor/plasteel/white,
/area/ruin/powered/clownplanet)
"Fr" = (
/turf/closed/wall/r_wall,
/area/ruin/powered/clownplanet)
"HE" = (
/turf/open/space/basic,
/area/space)
"IR" = (
/turf/closed/wall/r_wall/rust,
/area/ruin/powered/clownplanet)
"JG" = (
/obj/effect/decal/cleanable/blood/footprints,
/mob/living/simple_animal/hostile/illusion{
	atmos_requirements = list("min_oxy" = 0, "max_oxy" = 0, "min_tox" = 0, "max_tox" = 0, "min_co2" = 0, "max_co2" = 0, "min_n2" = 0, "max_n2" = 0);
	health = 200;
	maxHealth = 200;
	melee_damage_lower = 20;
	melee_damage_upper = 35
	},
/turf/open/floor/plasteel/tech,
/area/ruin/powered/clownplanet)
"JH" = (
/obj/structure/bed{
	dir = 0
	},
/obj/item/bedsheet/mime,
/turf/open/floor/plasteel/tech,
/area/ruin/powered/clownplanet)
"Ka" = (
/obj/machinery/light/small,
/turf/open/floor/plasteel/tech,
/area/ruin/powered/clownplanet)
"Ku" = (
/obj/machinery/light/broken{
	dir = 1
	},
/turf/open/floor/plasteel/tech,
/area/ruin/powered/clownplanet)
"KJ" = (
/obj/effect/turf_decal/box,
/obj/effect/spawner/lootdrop/memeorgans,
/obj/machinery/light/broken{
	dir = 8
	},
/obj/structure/closet/crate,
/turf/open/floor/plasteel/white,
/area/ruin/powered/clownplanet)
"KZ" = (
/obj/structure/table,
/obj/item/suppressor,
/turf/open/floor/plasteel/tech,
/area/ruin/powered/clownplanet)
"LS" = (
/obj/structure/table,
/obj/item/ammo_box/magazine/m10mm,
/obj/item/ammo_box/magazine/m10mm,
/turf/open/floor/plasteel/white,
/area/ruin/powered/clownplanet)
"Mv" = (
/obj/machinery/door/airlock/silver,
/turf/open/floor/plasteel/tech,
/area/ruin/powered/clownplanet)
"MU" = (
/mob/living/simple_animal/hostile/illusion{
	atmos_requirements = list("min_oxy" = 0, "max_oxy" = 0, "min_tox" = 0, "max_tox" = 0, "min_co2" = 0, "max_co2" = 0, "min_n2" = 0, "max_n2" = 0);
	health = 200;
	maxHealth = 200;
	melee_damage_lower = 20;
	melee_damage_upper = 35
	},
/turf/open/floor/plasteel/white,
/area/ruin/powered/clownplanet)
"MW" = (
/obj/structure/table/reinforced,
/obj/machinery/light/small,
/obj/item/reagent_containers/food/snacks/baguette,
/turf/open/floor/plasteel/tech/grid,
/area/ruin/powered/clownplanet)
"Na" = (
/obj/machinery/computer{
	desc = "A computer long since rendered non-functional due to lack of maintenance. Spitting out error messages.";
	dir = 8;
	name = "Broken Computer"
	},
/turf/open/floor/mineral/bananium/airless,
/area/awaymission)
"Nh" = (
/turf/closed/wall/mineral/silver,
/area/ruin/powered/clownplanet)
"Nl" = (
/obj/machinery/conveyor,
/turf/open/floor/plasteel/white,
/area/ruin/powered/clownplanet)
"NC" = (
/obj/structure/table/wood/fancy/black,
/obj/machinery/computer/security/wooden_tv,
/turf/open/floor/plasteel/white,
/area/ruin/powered/clownplanet)
"NZ" = (
/obj/effect/turf_decal/arrows,
/turf/open/floor/plasteel/tech,
/area/ruin/powered/clownplanet)
"Oa" = (
/obj/effect/decal/cleanable/blood/gibs/up,
/turf/open/floor/plasteel/tech,
/area/ruin/powered/clownplanet)
"Oh" = (
/obj/structure/door_assembly/door_assembly_bananium,
/turf/open/floor/mineral/bananium,
/area/awaymission)
"Pd" = (
/obj/effect/decal/cleanable/blood/footprints,
/obj/effect/mine/stun{
	alpha = 60
	},
/turf/open/floor/plasteel/tech,
/area/ruin/powered/clownplanet)
"Pg" = (
/obj/machinery/nuclearbomb/syndicate/bananium{
	anchored = 1
	},
/turf/open/floor/mineral/bananium/airless,
/area/awaymission)
"Pp" = (
/obj/effect/mine/shrapnel/human_only{
	alpha = 60
	},
/turf/open/floor/plasteel/tech,
/area/ruin/powered/clownplanet)
"Rf" = (
/obj/structure/table/wood/fancy/black,
/obj/item/paper/crumpled/bloody/ruins/thederelict/unfinished{
	desc = "Looks like someone started shakily writing a report...";
	info = "Project Reticence compromised. Infiltrator taken care of. Contact was achieved before disposal of the target. Facility and location compromised.";
	name = "scrapped report"
	},
/obj/machinery/light/small{
	dir = 1
	},
/turf/open/floor/plasteel/tech,
/area/ruin/powered/clownplanet)
"Ry" = (
/obj/structure/bed,
/obj/item/bedsheet/mime,
/turf/open/floor/plasteel/white,
/area/ruin/powered/clownplanet)
"Rz" = (
/obj/effect/turf_decal/box,
/obj/effect/spawner/lootdrop/prison_contraband,
/obj/structure/closet/crate,
/turf/open/floor/plasteel/white,
/area/ruin/powered/clownplanet)
"Sy" = (
/obj/machinery/light/dim{
	dir = 8
	},
/turf/open/floor/plasteel/white,
/area/ruin/powered/clownplanet)
"Tg" = (
/obj/structure/bed,
/turf/open/floor/plasteel/tech,
/area/ruin/powered/clownplanet)
"Tv" = (
/mob/living/simple_animal/hostile/illusion{
	atmos_requirements = list("min_oxy" = 0, "max_oxy" = 0, "min_tox" = 0, "max_tox" = 0, "min_co2" = 0, "max_co2" = 0, "min_n2" = 0, "max_n2" = 0);
	dir = 8;
	health = 200;
	maxHealth = 200;
	melee_damage_lower = 20;
	melee_damage_upper = 35
	},
/obj/machinery/light/small,
/turf/open/floor/plasteel/white,
/area/ruin/powered/clownplanet)
"Uh" = (
/obj/machinery/light/broken{
	dir = 4
	},
/turf/open/floor/plasteel/tech,
/area/ruin/powered/clownplanet)
"UV" = (
/obj/item/clothing/shoes/sneakers/mime,
/obj/item/clothing/mask/gas/mime,
/obj/item/clothing/under/rank/civilian/mime/skirt,
/obj/structure/closet,
/obj/item/clothing/head/beret/archaic,
/turf/open/floor/plasteel/tech,
/area/ruin/powered/clownplanet)
"UZ" = (
/obj/mecha/combat/reticence/loaded{
	internals_req_access = list();
	operation_req_access = list()
	},
/turf/open/floor/plasteel/patterned/grid,
/area/ruin/powered/clownplanet)
"Vj" = (
/obj/machinery/computer{
	desc = "A computer long since rendered non-functional due to lack of maintenance. Spitting out error messages.";
	dir = 4;
	name = "Broken Computer"
	},
/turf/open/floor/plasteel/white,
/area/ruin/powered/clownplanet)
"VT" = (
/turf/closed/wall/mineral/bananium,
/area/awaymission)
"Wu" = (
/obj/item/storage/backpack/duffelbag/clown/syndie,
/obj/effect/decal/cleanable/blood/gibs/torso,
/obj/effect/decal/cleanable/blood/innards,
/turf/open/floor/mineral/bananium/airless,
/area/awaymission)
"WL" = (
/obj/item/ammo_casing/c10mm{
	dir = 1
	},
/turf/open/floor/plating/asteroid/airless,
/area/awaymission)
"WN" = (
/obj/item/stamp/mime,
/obj/machinery/conveyor,
/turf/open/floor/plasteel/tech,
/area/ruin/powered/clownplanet)
"Xd" = (
/turf/open/floor/plating/asteroid/airless,
/area/awaymission)
"Xj" = (
/obj/effect/mine/shrapnel/human_only{
	alpha = 60
	},
/turf/open/floor/plasteel/white,
/area/ruin/powered/clownplanet)
"XI" = (
/obj/structure/table/reinforced,
/obj/item/book/granter/spell/mimery_blockade,
/obj/machinery/light/small{
	dir = 1
	},
/turf/open/floor/plasteel/tech/grid,
/area/ruin/powered/clownplanet)
"Zc" = (
/turf/open/floor/plasteel/patterned/grid,
/area/ruin/powered/clownplanet)
"Zm" = (
/turf/open/floor/plasteel/white,
/area/ruin/powered/clownplanet)
"Zq" = (
/obj/item/shard,
/turf/open/floor/mineral/bananium/airless,
/area/awaymission)
"ZP" = (
/obj/machinery/door/keycard/office{
	desc = "A heavily armored, mysterious airlock...";
	name = "armored airlock"
	},
/turf/open/floor/plasteel/tech,
/area/ruin/powered/clownplanet)
"ZQ" = (
/obj/effect/turf_decal/box,
/obj/effect/spawner/lootdrop/maintenance,
/obj/structure/closet/crate,
/turf/open/floor/plasteel/white,
/area/ruin/powered/clownplanet)

(1,1,1) = {"
HE
HE
HE
HE
HE
HE
HE
HE
HE
HE
HE
HE
HE
HE
HE
HE
HE
HE
HE
HE
HE
HE
HE
HE
HE
HE
HE
HE
HE
HE
HE
HE
HE
HE
HE
HE
HE
HE
HE
HE
HE
HE
HE
HE
HE
HE
HE
HE
HE
HE
HE
HE
HE
HE
HE
HE
HE
HE
HE
HE
HE
HE
HE
"}
(2,1,1) = {"
HE
HE
HE
HE
HE
HE
HE
HE
HE
HE
HE
HE
HE
HE
HE
HE
HE
HE
HE
HE
HE
HE
HE
HE
HE
HE
HE
HE
HE
HE
HE
HE
HE
HE
HE
HE
HE
HE
HE
HE
HE
HE
HE
HE
HE
HE
HE
HE
HE
HE
HE
HE
HE
HE
HE
HE
HE
HE
HE
HE
HE
HE
HE
"}
(3,1,1) = {"
HE
HE
HE
HE
HE
HE
HE
HE
HE
HE
HE
HE
HE
HE
HE
HE
HE
HE
HE
HE
HE
HE
HE
HE
HE
HE
HE
HE
HE
HE
HE
HE
HE
HE
HE
HE
HE
HE
HE
HE
HE
HE
HE
HE
HE
HE
HE
HE
HE
HE
HE
HE
HE
HE
HE
HE
HE
HE
HE
HE
HE
HE
HE
"}
(4,1,1) = {"
HE
HE
HE
HE
HE
HE
HE
HE
HE
HE
HE
HE
HE
HE
HE
HE
HE
HE
HE
HE
HE
HE
HE
HE
HE
HE
HE
HE
HE
HE
HE
HE
HE
HE
HE
HE
HE
HE
HE
HE
HE
HE
HE
HE
HE
HE
HE
HE
HE
HE
HE
HE
HE
HE
HE
HE
HE
HE
HE
HE
HE
HE
HE
"}
(5,1,1) = {"
HE
HE
HE
HE
HE
HE
HE
HE
HE
HE
HE
HE
HE
HE
HE
HE
HE
HE
HE
HE
HE
HE
HE
HE
HE
HE
HE
HE
HE
HE
HE
HE
HE
HE
HE
HE
HE
HE
HE
HE
HE
HE
HE
HE
HE
HE
HE
HE
HE
HE
HE
HE
HE
HE
HE
HE
HE
HE
HE
HE
HE
HE
HE
"}
(6,1,1) = {"
HE
HE
HE
HE
HE
HE
HE
HE
HE
HE
HE
HE
HE
HE
HE
HE
HE
HE
HE
HE
HE
HE
HE
HE
HE
HE
HE
HE
HE
HE
HE
HE
HE
HE
HE
HE
HE
HE
HE
HE
HE
HE
HE
HE
HE
HE
HE
HE
HE
HE
HE
qN
qN
qN
HE
HE
HE
HE
HE
HE
HE
HE
HE
"}
(7,1,1) = {"
HE
HE
HE
HE
HE
HE
HE
HE
HE
HE
HE
HE
HE
HE
HE
HE
HE
HE
HE
HE
HE
HE
HE
HE
HE
HE
HE
HE
HE
HE
HE
HE
HE
HE
HE
HE
HE
HE
HE
HE
HE
HE
HE
HE
HE
HE
HE
HE
HE
HE
HE
HE
qN
qN
qN
HE
HE
HE
HE
HE
HE
HE
HE
"}
(8,1,1) = {"
HE
HE
HE
HE
HE
HE
HE
HE
HE
HE
HE
HE
HE
HE
HE
HE
HE
HE
HE
HE
HE
HE
HE
HE
HE
HE
HE
HE
HE
HE
HE
HE
HE
HE
HE
HE
HE
HE
HE
HE
HE
HE
HE
HE
HE
HE
HE
HE
HE
HE
HE
HE
qN
qN
qN
qN
qN
HE
HE
HE
HE
HE
HE
"}
(9,1,1) = {"
HE
HE
HE
HE
HE
HE
HE
HE
HE
HE
HE
HE
HE
HE
HE
HE
HE
HE
HE
HE
HE
HE
HE
HE
HE
HE
HE
HE
HE
HE
HE
HE
HE
HE
HE
HE
HE
HE
HE
HE
HE
HE
HE
HE
HE
HE
HE
HE
HE
HE
HE
HE
HE
qN
qN
qN
qN
qN
HE
HE
HE
HE
HE
"}
(10,1,1) = {"
HE
HE
HE
HE
HE
HE
HE
HE
HE
HE
HE
HE
HE
HE
HE
HE
HE
HE
HE
HE
HE
HE
HE
HE
HE
HE
HE
HE
HE
HE
HE
HE
HE
HE
HE
HE
HE
HE
HE
HE
HE
HE
HE
HE
HE
HE
HE
HE
HE
HE
HE
HE
HE
HE
qN
qN
qN
qN
HE
HE
HE
HE
HE
"}
(11,1,1) = {"
HE
HE
HE
HE
HE
HE
HE
HE
HE
HE
HE
HE
HE
HE
HE
HE
HE
HE
HE
HE
HE
HE
HE
HE
HE
HE
HE
HE
HE
HE
HE
HE
HE
HE
HE
HE
HE
HE
HE
HE
HE
HE
HE
HE
HE
HE
HE
HE
HE
HE
HE
HE
HE
HE
HE
HE
qN
qN
HE
HE
HE
HE
HE
"}
(12,1,1) = {"
HE
HE
HE
HE
HE
HE
HE
HE
HE
HE
HE
HE
HE
HE
HE
HE
HE
HE
HE
HE
HE
HE
HE
HE
HE
HE
HE
HE
HE
HE
HE
HE
HE
HE
HE
HE
HE
HE
HE
qN
qN
HE
HE
HE
HE
HE
HE
HE
HE
HE
HE
HE
HE
HE
HE
HE
HE
HE
HE
HE
HE
HE
HE
"}
(13,1,1) = {"
HE
HE
HE
HE
HE
HE
HE
HE
HE
HE
HE
HE
HE
HE
HE
HE
HE
HE
HE
HE
HE
HE
HE
HE
HE
HE
HE
HE
HE
HE
HE
HE
HE
HE
HE
HE
HE
HE
Xd
qN
qN
qN
qN
HE
HE
HE
HE
HE
HE
HE
HE
HE
HE
HE
HE
HE
HE
HE
HE
HE
HE
HE
HE
"}
(14,1,1) = {"
HE
HE
HE
HE
HE
HE
HE
HE
HE
HE
HE
HE
HE
HE
HE
HE
HE
HE
HE
HE
HE
HE
HE
HE
HE
HE
HE
HE
HE
HE
HE
HE
HE
HE
HE
HE
HE
Xd
Xd
Xd
qN
qN
qN
qN
HE
HE
HE
HE
HE
HE
HE
HE
HE
HE
HE
HE
HE
HE
HE
HE
HE
HE
HE
"}
(15,1,1) = {"
HE
HE
HE
HE
HE
HE
HE
HE
HE
HE
HE
HE
HE
HE
HE
HE
HE
HE
HE
HE
HE
HE
HE
HE
HE
HE
HE
HE
HE
HE
HE
HE
HE
HE
HE
HE
Xd
Xd
Xd
qN
qN
qN
qN
qN
qN
HE
HE
HE
HE
HE
HE
HE
HE
HE
HE
HE
HE
HE
HE
HE
HE
HE
HE
"}
(16,1,1) = {"
HE
HE
HE
HE
HE
Xd
Xd
Xd
Xd
Xd
HE
HE
HE
HE
HE
HE
HE
HE
HE
HE
HE
HE
HE
HE
HE
HE
HE
HE
HE
HE
HE
HE
HE
HE
HE
qN
Xd
Xd
Xd
qN
qN
qN
qN
qN
qN
HE
HE
HE
HE
HE
HE
HE
HE
HE
HE
HE
HE
HE
HE
HE
HE
HE
HE
"}
(17,1,1) = {"
HE
HE
HE
HE
qN
Xd
Xd
Xd
Xd
Xd
Xd
qN
qN
HE
HE
HE
HE
HE
HE
HE
HE
HE
HE
HE
HE
HE
HE
HE
HE
HE
HE
HE
HE
HE
HE
qN
qN
Xd
Xd
Xd
qN
qN
qN
qN
qN
qN
HE
HE
HE
HE
HE
HE
HE
HE
HE
HE
HE
HE
HE
HE
HE
HE
HE
"}
(18,1,1) = {"
HE
HE
HE
qN
qN
Xd
Xd
Xd
WL
ji
qN
qN
qN
qN
qN
HE
HE
HE
HE
HE
HE
HE
HE
HE
HE
HE
HE
HE
HE
HE
HE
HE
HE
HE
qN
qN
qN
Xd
Xd
Xd
qN
qN
qN
qN
qN
qN
HE
HE
HE
HE
HE
HE
HE
HE
HE
HE
HE
HE
HE
HE
HE
HE
HE
"}
(19,1,1) = {"
HE
HE
HE
qN
qN
qN
sp
Zq
vb
sp
qN
qN
qN
qN
qN
qN
qN
HE
HE
HE
HE
HE
HE
HE
HE
HE
HE
HE
HE
HE
HE
HE
HE
HE
qN
qN
Xd
Xd
HE
HE
HE
HE
qN
qN
qN
qN
HE
HE
HE
HE
HE
HE
HE
HE
HE
qN
Xd
HE
HE
HE
HE
HE
HE
"}
(20,1,1) = {"
HE
HE
qN
qN
qN
qN
VT
Oh
ht
VT
qN
qN
qN
qN
qN
qN
qN
qN
qN
qN
HE
HE
HE
HE
HE
HE
HE
HE
HE
HE
HE
HE
HE
HE
HE
Xd
Xd
HE
HE
HE
HE
HE
HE
HE
HE
HE
HE
HE
HE
HE
HE
HE
HE
HE
qN
qN
Xd
HE
HE
HE
HE
HE
HE
"}
(21,1,1) = {"
HE
HE
qN
qN
qN
qN
VT
ki
Wu
VT
qN
qN
qN
qN
qN
qN
qN
qN
qN
qN
qN
HE
HE
HE
HE
HE
HE
HE
HE
HE
HE
HE
HE
HE
HE
HE
HE
HE
HE
HE
HE
HE
HE
HE
HE
HE
HE
HE
HE
HE
HE
HE
HE
HE
qN
qN
qN
HE
HE
HE
HE
HE
HE
"}
(22,1,1) = {"
HE
HE
qN
qN
qN
qN
VT
dc
mg
VT
qN
qN
qN
qN
qN
qN
qN
qN
qN
qN
qN
qN
HE
HE
HE
HE
HE
HE
HE
HE
HE
HE
HE
HE
HE
HE
HE
HE
HE
HE
HE
HE
HE
HE
HE
HE
HE
HE
HE
HE
HE
HE
HE
HE
qN
qN
qN
HE
HE
HE
HE
HE
HE
"}
(23,1,1) = {"
HE
qN
qN
qN
qN
qN
VT
Na
Pg
VT
qN
qN
qN
qN
qN
qN
qN
qN
qN
qN
qN
qN
qN
qN
HE
HE
HE
HE
HE
HE
HE
HE
HE
HE
HE
HE
HE
HE
HE
HE
HE
HE
HE
HE
HE
HE
HE
HE
HE
HE
HE
HE
HE
HE
HE
HE
HE
HE
HE
HE
HE
HE
HE
"}
(24,1,1) = {"
HE
qN
qN
qN
qN
qN
qN
VT
VT
qN
qN
qN
qN
qN
qN
qN
qN
qN
qN
qN
qN
qN
qN
qN
HE
HE
HE
HE
HE
HE
HE
HE
HE
HE
HE
HE
HE
HE
HE
HE
HE
HE
HE
HE
HE
HE
HE
HE
HE
HE
HE
HE
HE
HE
HE
HE
HE
HE
HE
HE
HE
HE
HE
"}
(25,1,1) = {"
HE
qN
qN
qN
qN
qN
qN
qN
qN
qN
qN
qN
qN
qN
qN
qN
qN
qN
qN
qN
qN
qN
qN
qN
qN
HE
HE
HE
HE
HE
HE
HE
HE
HE
HE
HE
HE
HE
HE
HE
HE
HE
HE
HE
HE
HE
HE
HE
HE
HE
HE
HE
HE
HE
HE
HE
HE
HE
HE
HE
HE
HE
HE
"}
(26,1,1) = {"
qN
qN
qN
qN
qN
qN
qN
qN
qN
qN
qN
qN
qN
qN
qN
qN
qN
qN
qN
qN
qN
qN
qN
qN
qN
HE
HE
HE
HE
HE
HE
HE
HE
HE
HE
HE
HE
HE
HE
HE
HE
HE
HE
HE
HE
HE
HE
HE
HE
HE
HE
HE
HE
HE
HE
HE
HE
HE
HE
HE
HE
HE
HE
"}
(27,1,1) = {"
qN
qN
qN
qN
qN
qN
Fr
Fr
IR
Fr
Fr
Fr
IR
Fr
IR
IR
Fr
Fr
IR
Fr
IR
Fr
Fr
IR
IR
qN
HE
HE
HE
HE
HE
HE
HE
HE
HE
HE
HE
HE
HE
HE
HE
HE
HE
HE
HE
HE
HE
HE
HE
HE
HE
HE
HE
HE
HE
HE
HE
HE
HE
HE
HE
HE
HE
"}
(28,1,1) = {"
qN
qN
qN
qN
qN
qN
IR
Nh
Nh
Nh
Nh
Nh
Nh
Nh
Nh
Nh
Nh
Nh
Nh
Nh
Nh
Nh
Nh
Nh
Fr
qN
qN
HE
HE
HE
HE
HE
HE
HE
HE
HE
HE
HE
HE
HE
HE
HE
HE
HE
HE
HE
HE
HE
HE
HE
HE
HE
HE
HE
HE
HE
HE
HE
HE
HE
HE
HE
HE
"}
(29,1,1) = {"
qN
qN
qN
qN
qN
qN
IR
Nh
Bz
mD
Nh
Zm
NZ
Zm
NZ
Sy
NZ
Zm
NZ
Zm
fZ
KJ
BR
Nh
Fr
qN
qN
qN
HE
HE
HE
HE
HE
HE
HE
HE
HE
HE
HE
HE
HE
HE
HE
HE
HE
HE
HE
HE
HE
HE
HE
HE
HE
HE
HE
HE
HE
HE
HE
HE
HE
HE
HE
"}
(30,1,1) = {"
qN
qN
qN
qN
qN
qN
IR
Nh
mD
Bz
iG
Dn
Nl
WN
Nl
no
Az
no
Ch
no
ZQ
Dp
Rz
Nh
IR
qN
qN
qN
qN
HE
HE
HE
HE
HE
HE
HE
HE
HE
HE
HE
HE
HE
HE
HE
HE
HE
HE
HE
HE
HE
HE
HE
HE
HE
HE
HE
HE
HE
HE
HE
HE
HE
HE
"}
(31,1,1) = {"
HE
qN
qN
qN
qN
qN
Fr
Nh
Nh
Nh
Nh
Xj
NZ
Vj
NZ
MU
NZ
Vj
NZ
CA
ya
ZQ
fZ
Nh
IR
qN
qN
qN
qN
HE
HE
HE
HE
HE
HE
HE
HE
HE
HE
HE
HE
HE
HE
HE
HE
HE
HE
HE
HE
HE
HE
HE
HE
HE
HE
HE
HE
HE
HE
HE
HE
HE
HE
"}
(32,1,1) = {"
HE
qN
qN
qN
qN
qN
Fr
Nh
NC
fa
Nh
fa
Zm
fa
Zm
fa
Zm
fa
Zm
fa
uK
fZ
ZQ
Nh
IR
qN
qN
qN
qN
HE
HE
HE
HE
HE
HE
HE
HE
HE
HE
HE
HE
HE
HE
HE
HE
HE
HE
HE
HE
HE
HE
HE
HE
HE
HE
HE
HE
HE
HE
HE
HE
HE
HE
"}
(33,1,1) = {"
HE
HE
qN
qN
qN
qN
IR
Nh
Rf
MU
Mv
Zm
fa
Zm
Pp
Zm
fa
Zm
fa
Zm
fa
Zm
fa
yg
fa
lo
wP
qN
qN
qN
HE
HE
HE
HE
HE
HE
HE
HE
HE
HE
HE
HE
HE
HE
HE
HE
HE
HE
HE
HE
HE
HE
HE
HE
HE
HE
HE
HE
HE
HE
HE
HE
HE
"}
(34,1,1) = {"
HE
HE
qN
qN
qN
qN
Fr
Nh
zx
fa
Nh
fa
Zm
fa
Zm
fa
MU
fa
Zm
fa
Zm
fa
Zm
Mv
Zm
wP
lo
Xd
qN
Xd
Xd
HE
HE
HE
HE
HE
HE
HE
HE
HE
HE
HE
HE
HE
HE
HE
HE
HE
HE
HE
HE
HE
HE
HE
HE
HE
HE
HE
HE
HE
HE
HE
HE
"}
(35,1,1) = {"
HE
HE
qN
qN
qN
qN
IR
Nh
Nh
Nh
Nh
Nh
Nh
Nh
Nh
Zm
fa
Zm
fa
Zm
qB
Zm
fa
Nh
Fr
qN
Xd
Xd
Xd
Xd
Xd
HE
HE
HE
HE
HE
HE
HE
HE
HE
HE
HE
HE
HE
HE
HE
HE
HE
HE
HE
HE
HE
HE
HE
HE
HE
HE
HE
HE
HE
HE
HE
HE
"}
(36,1,1) = {"
HE
HE
HE
qN
qN
qN
Fr
Nh
pc
fa
yg
fa
Sy
fe
Nh
fa
Zm
fa
Zm
Uh
Zm
Uh
Zm
Nh
IR
qN
qN
Xd
Xd
Xd
Xd
HE
HE
HE
HE
HE
HE
HE
HE
HE
HE
HE
HE
HE
HE
HE
HE
HE
HE
HE
HE
HE
HE
HE
HE
HE
HE
HE
HE
HE
HE
HE
HE
"}
(37,1,1) = {"
HE
HE
HE
qN
qN
qN
Fr
Nh
JH
Tv
Nh
Zm
fa
Fj
Nh
Zm
qB
Nh
Nh
Nh
Mv
Nh
Nh
Nh
Fr
qN
qN
qN
qN
qN
Xd
HE
HE
HE
HE
HE
HE
HE
HE
HE
HE
HE
HE
HE
HE
HE
HE
HE
HE
HE
HE
HE
HE
HE
HE
HE
HE
HE
HE
HE
HE
HE
HE
"}
(38,1,1) = {"
HE
HE
HE
qN
qN
qN
Fr
Nh
Nh
Nh
Nh
fa
MU
KZ
Nh
Ku
Zm
Nh
MU
fa
Zm
fa
Zm
Nh
Fr
qN
qN
qN
qN
qN
qN
HE
HE
HE
HE
HE
HE
HE
HE
HE
HE
HE
HE
HE
HE
HE
HE
HE
HE
HE
HE
HE
HE
HE
HE
HE
HE
HE
HE
HE
HE
HE
HE
"}
(39,1,1) = {"
HE
HE
HE
qN
qN
qN
IR
Nh
UV
Zm
Mv
Zm
fa
LS
Nh
Zm
fa
Nh
fa
AL
ib
AL
Pp
Nh
Fr
qN
qN
qN
qN
qN
qN
HE
HE
HE
HE
HE
HE
HE
HE
HE
HE
HE
HE
HE
HE
HE
HE
HE
HE
HE
HE
HE
HE
HE
HE
HE
HE
HE
HE
HE
HE
HE
HE
"}
(40,1,1) = {"
HE
HE
HE
HE
qN
qN
Fr
Nh
Ry
Ka
Nh
fa
Zm
fa
Nh
fa
Zm
Nh
Zm
fa
Zm
fa
AL
Nh
IR
qN
qN
qN
qN
qN
qN
HE
HE
HE
HE
HE
HE
HE
HE
HE
HE
HE
HE
HE
HE
HE
HE
HE
HE
HE
HE
HE
HE
HE
HE
HE
HE
HE
HE
HE
HE
HE
HE
"}
(41,1,1) = {"
HE
HE
HE
HE
qN
qN
Fr
Nh
Nh
Nh
Nh
Zm
fa
Zm
Nh
Zm
fa
Nh
ib
AL
ib
Zm
aa
Nh
IR
qN
qN
qN
qN
qN
qN
HE
HE
HE
HE
HE
HE
HE
HE
HE
HE
HE
HE
HE
HE
HE
HE
HE
HE
HE
HE
HE
HE
HE
HE
HE
HE
HE
HE
HE
HE
HE
HE
"}
(42,1,1) = {"
HE
HE
HE
HE
HE
qN
IR
Nh
yy
Oa
um
gj
tN
Pd
gh
JG
tU
Nh
AL
ps
Cd
fa
AL
Nh
Fr
qN
qN
qN
qN
qN
qN
HE
HE
HE
HE
HE
HE
HE
HE
HE
HE
HE
HE
HE
HE
HE
HE
HE
HE
HE
HE
HE
HE
HE
HE
HE
HE
HE
HE
HE
HE
HE
HE
"}
(43,1,1) = {"
HE
HE
HE
HE
HE
qN
Fr
Nh
Tg
cN
Nh
Zm
Uh
Zm
Nh
Nh
Nh
Nh
nT
AL
fa
Zm
fa
Nh
Fr
qN
qN
qN
qN
qN
qN
HE
HE
HE
HE
HE
HE
HE
HE
HE
HE
HE
HE
HE
HE
HE
HE
HE
HE
HE
HE
HE
HE
HE
HE
HE
HE
HE
HE
HE
HE
HE
HE
"}
(44,1,1) = {"
HE
HE
HE
HE
HE
qN
Fr
Nh
Nh
Nh
Nh
Nh
Nh
Nh
Nh
fa
wh
fa
Zm
fa
Zm
ib
Zm
Nh
Fr
qN
qN
qN
qN
qN
qN
HE
HE
HE
HE
HE
HE
HE
HE
HE
HE
HE
HE
HE
HE
HE
HE
HE
HE
HE
HE
HE
HE
HE
HE
HE
HE
HE
HE
HE
HE
HE
HE
"}
(45,1,1) = {"
HE
HE
HE
HE
HE
qN
IR
Fr
IR
IR
Fr
IR
Fr
Fr
Nh
AL
ib
Zm
ib
AL
aa
AL
pM
Nh
IR
qN
qN
qN
qN
qN
qN
HE
HE
HE
HE
HE
HE
HE
HE
HE
HE
HE
HE
HE
HE
HE
HE
HE
HE
HE
HE
HE
HE
HE
HE
HE
HE
HE
HE
HE
HE
HE
HE
"}
(46,1,1) = {"
HE
HE
HE
HE
HE
qN
qN
qN
qN
qN
qN
qN
qN
Fr
Nh
cO
AL
fa
Zm
fa
Zm
fa
AL
Nh
Fr
qN
qN
qN
qN
qN
HE
HE
HE
HE
HE
HE
HE
HE
HE
HE
HE
HE
HE
HE
HE
HE
HE
HE
HE
HE
HE
HE
HE
HE
HE
HE
HE
HE
HE
HE
HE
HE
HE
"}
(47,1,1) = {"
HE
HE
HE
HE
HE
HE
qN
qN
qN
qN
qN
qN
qN
IR
Nh
Zm
ib
Zm
ib
AL
ib
Zm
qB
Nh
IR
qN
qN
qN
qN
qN
HE
HE
HE
HE
HE
HE
HE
HE
HE
HE
HE
HE
HE
HE
HE
HE
HE
HE
HE
qN
qN
qN
qN
qN
qN
HE
HE
HE
HE
HE
HE
HE
HE
"}
(48,1,1) = {"
HE
HE
HE
HE
HE
HE
qN
qN
qN
qN
qN
qN
qN
IR
Nh
fa
Zm
fa
AL
fa
nP
fa
Zm
Nh
Fr
qN
qN
qN
qN
qN
HE
HE
HE
HE
HE
HE
HE
HE
HE
HE
HE
HE
HE
HE
HE
HE
HE
HE
qN
qN
qN
qN
qN
qN
qN
qN
qN
HE
HE
HE
HE
HE
HE
"}
(49,1,1) = {"
HE
HE
HE
HE
HE
HE
HE
qN
qN
qN
qN
qN
qN
IR
Nh
Nh
Nh
Nh
vz
fH
ZP
fH
vz
Nh
IR
qN
qN
qN
qN
qN
HE
HE
HE
HE
HE
HE
HE
HE
HE
HE
HE
HE
HE
HE
HE
HE
HE
HE
qN
qN
qN
qN
qN
qN
qN
qN
qN
HE
HE
HE
HE
HE
HE
"}
(50,1,1) = {"
HE
HE
HE
HE
HE
HE
HE
HE
qN
qN
qN
qN
qN
Fr
Fr
IR
Fr
Nh
vz
XI
Zc
MW
vz
Nh
Fr
qN
qN
qN
qN
qN
HE
HE
HE
HE
HE
HE
HE
HE
HE
HE
HE
HE
HE
HE
HE
HE
HE
HE
qN
qN
qN
qN
qN
qN
qN
qN
qN
HE
HE
HE
HE
HE
HE
"}
(51,1,1) = {"
HE
HE
HE
HE
HE
HE
HE
HE
HE
HE
qN
qN
qN
qN
qN
qN
Fr
Nh
vz
UZ
hZ
Zc
vz
Nh
Fr
qN
qN
qN
qN
qN
HE
HE
HE
HE
HE
HE
HE
HE
HE
HE
HE
HE
HE
HE
HE
HE
HE
HE
qN
qN
qN
qN
qN
qN
qN
qN
qN
HE
HE
HE
HE
HE
HE
"}
(52,1,1) = {"
HE
HE
HE
HE
HE
HE
HE
HE
HE
HE
HE
qN
qN
qN
qN
qN
IR
Nh
vz
he
Zc
wT
vz
Nh
Fr
qN
qN
qN
qN
HE
HE
HE
HE
HE
HE
HE
HE
HE
HE
HE
HE
HE
HE
HE
HE
HE
HE
HE
qN
qN
qN
qN
qN
qN
qN
qN
qN
HE
HE
HE
HE
HE
HE
"}
(53,1,1) = {"
HE
HE
HE
HE
HE
HE
HE
HE
HE
HE
HE
HE
qN
qN
qN
qN
IR
Nh
vz
vz
vz
vz
vz
Nh
Fr
qN
qN
qN
qN
HE
HE
HE
HE
HE
HE
HE
HE
HE
HE
HE
HE
HE
HE
HE
HE
HE
HE
HE
HE
qN
qN
qN
qN
qN
qN
qN
HE
HE
HE
HE
HE
HE
HE
"}
(54,1,1) = {"
HE
HE
HE
HE
HE
HE
HE
HE
HE
HE
HE
HE
HE
qN
qN
qN
Fr
Nh
Nh
Nh
Nh
Nh
Nh
Nh
IR
qN
qN
qN
qN
HE
HE
HE
HE
HE
HE
HE
HE
HE
HE
HE
HE
HE
HE
HE
HE
HE
HE
HE
HE
qN
qN
qN
qN
qN
qN
qN
HE
HE
HE
HE
HE
HE
HE
"}
(55,1,1) = {"
HE
HE
HE
HE
HE
HE
HE
HE
HE
HE
HE
HE
HE
HE
qN
qN
Fr
IR
Fr
Fr
IR
Fr
Fr
IR
IR
qN
qN
qN
HE
HE
HE
HE
HE
HE
HE
HE
HE
HE
HE
HE
HE
HE
HE
HE
HE
HE
HE
HE
HE
qN
qN
qN
qN
qN
qN
qN
HE
HE
HE
HE
HE
HE
HE
"}
(56,1,1) = {"
HE
HE
HE
HE
HE
HE
HE
HE
HE
HE
HE
HE
HE
HE
qN
qN
qN
qN
qN
qN
qN
qN
qN
qN
qN
qN
qN
qN
HE
HE
HE
HE
HE
HE
HE
HE
HE
HE
HE
HE
HE
HE
HE
HE
HE
HE
HE
HE
HE
qN
qN
qN
qN
qN
HE
HE
HE
HE
HE
HE
HE
HE
HE
"}
(57,1,1) = {"
HE
HE
HE
HE
HE
HE
HE
HE
HE
HE
HE
HE
HE
HE
HE
qN
qN
qN
qN
qN
qN
qN
qN
qN
qN
qN
qN
HE
HE
HE
HE
HE
HE
HE
HE
HE
HE
HE
HE
HE
HE
HE
HE
HE
HE
HE
HE
HE
HE
HE
qN
qN
qN
HE
HE
HE
HE
HE
HE
HE
HE
HE
HE
"}
(58,1,1) = {"
HE
HE
HE
HE
HE
HE
HE
HE
HE
HE
HE
HE
HE
HE
HE
HE
HE
qN
qN
qN
qN
qN
qN
qN
HE
HE
HE
HE
HE
HE
HE
HE
HE
HE
HE
HE
HE
HE
HE
HE
HE
HE
HE
HE
HE
HE
HE
HE
HE
HE
HE
qN
HE
HE
HE
HE
HE
HE
HE
HE
HE
HE
HE
"}
(59,1,1) = {"
HE
HE
HE
HE
HE
HE
HE
HE
HE
HE
HE
HE
HE
HE
HE
HE
HE
HE
HE
HE
HE
HE
HE
HE
HE
HE
HE
HE
HE
HE
HE
HE
HE
HE
HE
HE
HE
HE
HE
HE
HE
HE
HE
HE
HE
HE
HE
HE
HE
HE
HE
HE
HE
HE
HE
HE
HE
HE
HE
HE
HE
HE
HE
"}
(60,1,1) = {"
HE
HE
HE
HE
HE
HE
HE
HE
HE
HE
HE
HE
HE
HE
HE
HE
HE
HE
HE
HE
HE
HE
HE
HE
HE
HE
HE
HE
HE
HE
HE
HE
HE
HE
HE
HE
HE
HE
HE
HE
HE
HE
HE
HE
HE
HE
HE
HE
HE
HE
HE
HE
HE
HE
HE
HE
HE
HE
HE
HE
HE
HE
HE
"}
(61,1,1) = {"
HE
HE
HE
HE
HE
HE
HE
HE
HE
HE
HE
HE
HE
HE
HE
HE
HE
HE
HE
HE
HE
HE
HE
HE
HE
HE
HE
HE
HE
HE
HE
HE
HE
HE
HE
HE
HE
HE
HE
HE
HE
HE
HE
HE
HE
HE
HE
HE
HE
HE
HE
HE
HE
HE
HE
HE
HE
HE
HE
HE
HE
HE
HE
"}
(62,1,1) = {"
HE
HE
HE
HE
HE
HE
HE
HE
HE
HE
HE
HE
HE
HE
HE
HE
HE
HE
HE
HE
HE
HE
HE
HE
HE
HE
HE
HE
HE
HE
HE
HE
HE
HE
HE
HE
HE
HE
HE
HE
HE
HE
HE
HE
HE
HE
HE
HE
HE
HE
HE
HE
HE
HE
HE
HE
HE
HE
HE
HE
HE
HE
HE
"}
(63,1,1) = {"
HE
HE
HE
HE
HE
HE
HE
HE
HE
HE
HE
HE
HE
HE
HE
HE
HE
HE
HE
HE
HE
HE
HE
HE
HE
HE
HE
HE
HE
HE
HE
HE
HE
HE
HE
HE
HE
HE
HE
HE
HE
HE
HE
HE
HE
HE
HE
HE
HE
HE
HE
HE
HE
HE
HE
HE
HE
HE
HE
HE
HE
HE
HE
"}
