//MAP CONVERTED BY dmm2tgm.py THIS HEADER COMMENT PREVENTS RECONVERSION, DO NOT REMOVE
"aI" = (
/obj/effect/landmark/portal_exit{
	id = "portalnumero9"
	},
/obj/machinery/light/floor{
	alpha = 0
	},
/turf/open/floor/carpet/red,
/area/wizard_station)
"aV" = (
/obj/effect/landmark/portal_exit{
	id = "portalnumero12"
	},
/obj/machinery/light/floor{
	alpha = 0
	},
/turf/open/floor/carpet/red,
/area/wizard_station)
"aZ" = (
/obj/effect/landmark/portal_exit{
	id = "portalnumero21"
	},
/obj/machinery/light/floor{
	alpha = 0
	},
/turf/open/floor/carpet/red,
/area/wizard_station)
"bb" = (
/obj/effect/portal/permanent/one_way{
	id = "portalnumero16"
	},
/turf/open/floor/carpet/red,
/area/wizard_station)
"bB" = (
/obj/effect/landmark/portal_exit{
	id = "portalnumero17"
	},
/obj/machinery/light/floor{
	alpha = 0
	},
/turf/open/floor/carpet/red,
/area/wizard_station)
"eF" = (
/obj/machinery/light/floor{
	alpha = 0
	},
/turf/open/floor/carpet/purple,
/area/wizard_station)
"fb" = (
/obj/effect/portal/permanent/one_way{
	id = "portalnumero19"
	},
/turf/open/floor/carpet/red,
/area/wizard_station)
"fw" = (
/obj/effect/landmark/portal_exit{
	id = "portalnumero18"
	},
/obj/machinery/light/floor{
	alpha = 0
	},
/turf/open/floor/carpet/red,
/area/wizard_station)
"gr" = (
/obj/effect/landmark/portal_exit{
	id = "portalnumero16"
	},
/obj/machinery/light/floor{
	alpha = 0
	},
/turf/open/floor/carpet/red,
/area/wizard_station)
"hd" = (
/obj/effect/portal/permanent/one_way{
	id = "portalnumero21"
	},
/turf/open/floor/carpet/red,
/area/wizard_station)
"hf" = (
/obj/effect/portal/permanent/one_way{
	id = "portalnumero17"
	},
/turf/open/floor/carpet/red,
/area/wizard_station)
"hh" = (
/obj/effect/landmark/portal_exit{
	id = "portalnumero26"
	},
/obj/machinery/light/floor{
	alpha = 0
	},
/turf/open/floor/carpet/red,
/area/wizard_station)
"ix" = (
/obj/effect/portal/permanent/one_way{
	id = "portalnumero22"
	},
/turf/open/floor/carpet/red,
/area/wizard_station)
"iH" = (
/obj/effect/portal/permanent/one_way{
	id = "portalnumero28"
	},
/turf/open/floor/carpet/red,
/area/wizard_station)
"jA" = (
/turf/open/floor/carpet/red,
/area/wizard_station)
"jU" = (
/obj/effect/portal/permanent/one_way{
	id = "portalnumero31"
	},
/turf/open/floor/carpet/blue,
/area/wizard_station)
"jX" = (
/obj/effect/landmark/portal_exit{
	id = "portalnumero8"
	},
/obj/machinery/light/floor{
	alpha = 0
	},
/turf/open/floor/carpet/red,
/area/wizard_station)
"mI" = (
/obj/effect/landmark/portal_exit{
	id = "portalnumero3"
	},
/obj/machinery/light/floor{
	alpha = 0
	},
/turf/open/floor/carpet/red,
/area/wizard_station)
"nO" = (
/obj/effect/portal/permanent/one_way{
	id = "portalnumero7"
	},
/turf/open/floor/carpet/red,
/area/wizard_station)
"oy" = (
/obj/effect/portal/permanent/one_way{
	id = "portalnumero4"
	},
/turf/open/floor/carpet/red,
/area/wizard_station)
"oZ" = (
/obj/effect/portal/permanent/one_way{
	id = "portalnumero2o"
	},
/turf/open/floor/carpet/red,
/area/wizard_station)
"qu" = (
/obj/effect/portal/permanent/one_way{
	id = "portalnumero5"
	},
/turf/open/floor/carpet/red,
/area/wizard_station)
"qS" = (
/obj/structure/table/wood/fancy/red,
/obj/item/clothing/head/wizard/red,
/obj/item/clothing/suit/wizrobe/red,
/obj/item/clothing/shoes/sandal/magic,
/turf/open/floor/carpet/blue,
/area/wizard_station)
"tK" = (
/obj/effect/portal/permanent/one_way{
	id = "portalnumero23"
	},
/turf/open/floor/carpet/red,
/area/wizard_station)
"tV" = (
/obj/structure/table/wood/fancy/green,
/obj/item/spellbook{
	desc = "An unearthly tome that glows with power. It's missing a few pages, but you can still understand some of it.";
	name = "lesser spell book";
	uses = 5
	},
/obj/machinery/light/floor{
	alpha = 0
	},
/turf/open/floor/carpet/blue,
/area/wizard_station)
"ub" = (
/obj/effect/portal/permanent/one_way{
	id = "portalnumero14"
	},
/turf/open/floor/carpet/red,
/area/wizard_station)
"uy" = (
/obj/effect/landmark/portal_exit{
	id = "portalnumero0"
	},
/turf/open/floor/carpet/purple,
/area/wizard_station)
"vb" = (
/obj/effect/landmark/portal_exit{
	id = "portalnumero13"
	},
/obj/machinery/light/floor{
	alpha = 0
	},
/turf/open/floor/carpet/red,
/area/wizard_station)
"vk" = (
/obj/effect/portal/permanent/one_way{
	id = "portalnumero2"
	},
/turf/open/floor/carpet/red,
/area/wizard_station)
"vs" = (
/obj/effect/landmark/portal_exit{
	id = "portalnumero4"
	},
/obj/machinery/light/floor{
	alpha = 0;
	light_range = 3
	},
/turf/open/floor/carpet/red,
/area/wizard_station)
"vJ" = (
/obj/effect/landmark/portal_exit{
	id = "portalnumero23"
	},
/obj/machinery/light/floor{
	alpha = 0
	},
/turf/open/floor/carpet/red,
/area/wizard_station)
"vM" = (
/obj/effect/portal/permanent/one_way{
	id = "portalnumero15"
	},
/turf/open/floor/carpet/red,
/area/wizard_station)
"vY" = (
/obj/effect/portal/permanent/one_way{
	id = "portalnumero8"
	},
/turf/open/floor/carpet/red,
/area/wizard_station)
"wC" = (
/obj/effect/portal/permanent/one_way{
	id = "portalnumero29"
	},
/turf/open/floor/carpet/red,
/area/wizard_station)
"wO" = (
/turf/closed/indestructible/riveted/uranium{
	name = "emerald wall"
	},
/area/wizard_station)
"yd" = (
/obj/effect/landmark/portal_exit{
	id = "portalnumero31"
	},
/turf/open/floor/carpet/purple,
/area/wizard_station)
"yw" = (
/obj/effect/landmark/portal_exit{
	id = "portalnumero5"
	},
/obj/machinery/light/floor{
	alpha = 0
	},
/turf/open/floor/carpet/red,
/area/wizard_station)
"za" = (
/obj/structure/table/wood/fancy/green,
/obj/item/paper/fluff/ruins{
	info = "Greetings acolyte! Congratulations on completing thy first reality bending course! Before thou taketh thy garbs and tome, thy shalt be cautious, for reality bending spells such as Event Summoning, have their magic circles corrupted, and will be futile to learn such spells. Congratulations again, and thou shalt prepare for thy next exam!";
	name = "A word of caution"
	},
/turf/open/floor/carpet/blue,
/area/wizard_station)
"zu" = (
/obj/effect/landmark/portal_exit{
	id = "portalnumero11"
	},
/obj/machinery/light/floor{
	alpha = 0;
	light_range = 3
	},
/turf/open/floor/carpet/red,
/area/wizard_station)
"Ap" = (
/obj/effect/landmark/portal_exit{
	id = "portalnumero29"
	},
/obj/machinery/light/floor{
	alpha = 0
	},
/turf/open/floor/carpet/red,
/area/wizard_station)
"AL" = (
/obj/effect/landmark/portal_exit{
	id = "portalnumero7"
	},
/obj/machinery/light/floor{
	alpha = 0
	},
/turf/open/floor/carpet/red,
/area/wizard_station)
"BD" = (
/obj/effect/portal/permanent/one_way{
	id = "portalnumero3o"
	},
/turf/open/floor/carpet/red,
/area/wizard_station)
"Ck" = (
/obj/effect/landmark/portal_exit{
	id = "portalnumero19"
	},
/obj/machinery/light/floor{
	alpha = 0
	},
/turf/open/floor/carpet/red,
/area/wizard_station)
"Dm" = (
/obj/structure/showcase{
	desc = "A historical figure of great importance to the wizard federation. He spent his long life learning magic, stealing artifacts, and harassing idiots with swords. May he rest forever, Rodney.";
	icon = 'icons/mob/mob.dmi';
	icon_state = "nim";
	name = "wizard of yendor showcase"
	},
/turf/open/floor/carpet/blue,
/area/wizard_station)
"Dr" = (
/turf/open/floor/carpet/purple,
/area/wizard_station)
"DC" = (
/obj/effect/landmark/portal_exit{
	id = "portalnumero22"
	},
/obj/machinery/light/floor{
	alpha = 0
	},
/turf/open/floor/carpet/red,
/area/wizard_station)
"DG" = (
/obj/effect/landmark/portal_exit{
	id = "portalnumero25"
	},
/obj/machinery/light/floor{
	alpha = 0
	},
/turf/open/floor/carpet/red,
/area/wizard_station)
"Ed" = (
/obj/structure/table/wood/fancy/royalblue,
/obj/item/clothing/head/wizard,
/obj/item/clothing/suit/wizrobe,
/obj/item/clothing/shoes/sandal/magic,
/turf/open/floor/carpet/blue,
/area/wizard_station)
"Ga" = (
/obj/effect/portal/permanent/one_way{
	id = "portalnumero1"
	},
/turf/open/floor/carpet/red,
/area/wizard_station)
"Gy" = (
/obj/effect/portal/permanent/one_way{
	id = "portalnumero12"
	},
/turf/open/floor/carpet/red,
/area/wizard_station)
"GE" = (
/obj/effect/portal/permanent/one_way{
	id = "portalnumero1"
	},
/turf/open/floor/carpet/purple,
/area/wizard_station)
"GL" = (
/obj/machinery/light/floor{
	alpha = 0
	},
/turf/open/floor/carpet/blue,
/area/wizard_station)
"HF" = (
/obj/effect/portal/permanent/one_way{
	id = "portalnumero3"
	},
/turf/open/floor/carpet/red,
/area/wizard_station)
"HN" = (
/obj/effect/landmark/portal_exit{
	id = "portalnumero27"
	},
/obj/machinery/light/floor{
	alpha = 0
	},
/turf/open/floor/carpet/red,
/area/wizard_station)
"Id" = (
/obj/effect/landmark/portal_exit{
	id = "portalnumero1"
	},
/obj/machinery/light/floor{
	alpha = 0
	},
/turf/open/floor/carpet/red,
/area/wizard_station)
"IF" = (
/turf/open/floor/carpet/blue,
/area/wizard_station)
"IL" = (
/obj/effect/portal/permanent/one_way{
	id = "portalnumero11"
	},
/turf/open/floor/carpet/red,
/area/wizard_station)
"KE" = (
/obj/effect/portal/permanent/one_way{
	id = "portalnumero1o"
	},
/turf/open/floor/carpet/red,
/area/wizard_station)
"KI" = (
/obj/effect/portal/permanent/one_way{
	id = "portalnumero13"
	},
/turf/open/floor/carpet/red,
/area/wizard_station)
"LK" = (
/obj/effect/landmark/portal_exit{
	id = "portalnumero2o"
	},
/obj/machinery/light/floor{
	alpha = 0
	},
/turf/open/floor/carpet/red,
/area/wizard_station)
"LL" = (
/obj/effect/portal/permanent/one_way{
	id = "portalnumero27"
	},
/turf/open/floor/carpet/red,
/area/wizard_station)
"Mr" = (
/obj/effect/portal/permanent/one_way{
	id = "portalnumero25"
	},
/turf/open/floor/carpet/red,
/area/wizard_station)
"Mu" = (
/obj/effect/portal/permanent/one_way{
	id = "portalnumero18"
	},
/turf/open/floor/carpet/red,
/area/wizard_station)
"MP" = (
/obj/effect/landmark/portal_exit{
	id = "portalnumero24"
	},
/obj/machinery/light/floor{
	alpha = 0
	},
/turf/open/floor/carpet/red,
/area/wizard_station)
"MX" = (
/obj/effect/landmark/portal_exit{
	id = "portalnumero14"
	},
/obj/machinery/light/floor{
	alpha = 0
	},
/turf/open/floor/carpet/red,
/area/wizard_station)
"Ne" = (
/obj/effect/portal/permanent/one_way{
	id = "portalnumero0"
	},
/turf/open/floor/carpet/red,
/area/wizard_station)
"Nn" = (
/obj/effect/portal/permanent/one_way{
	id = "portalnumero9"
	},
/turf/open/floor/carpet/red,
/area/wizard_station)
"Nu" = (
/obj/effect/portal/permanent/one_way{
	id = "portalnumero24"
	},
/turf/open/floor/carpet/red,
/area/wizard_station)
"Qj" = (
/obj/effect/landmark/portal_exit{
	id = "portalnumero1o"
	},
/obj/machinery/light/floor{
	alpha = 0
	},
/turf/open/floor/carpet/red,
/area/wizard_station)
"ST" = (
/obj/effect/portal/permanent/one_way{
	id = "portalnumero6"
	},
/turf/open/floor/carpet/red,
/area/wizard_station)
"TG" = (
/obj/effect/landmark/portal_exit{
	id = "portalnumero6"
	},
/obj/machinery/light/floor{
	alpha = 0
	},
/turf/open/floor/carpet/red,
/area/wizard_station)
"WB" = (
/obj/effect/portal/permanent/one_way{
	id = "portalnumero26"
	},
/turf/open/floor/carpet/red,
/area/wizard_station)
"XD" = (
/obj/effect/portal/permanent/one_way{
	id = "portalnumero0"
	},
/turf/open/floor/carpet/purple,
/area/wizard_station)
"XJ" = (
/obj/effect/landmark/portal_exit{
	id = "portalnumero3o"
	},
/turf/open/floor/carpet/blue,
/area/wizard_station)
"XP" = (
/obj/effect/landmark/portal_exit{
	id = "portalnumero28"
	},
/obj/machinery/light/floor{
	alpha = 0
	},
/turf/open/floor/carpet/red,
/area/wizard_station)
"Yx" = (
/obj/effect/landmark/portal_exit{
	id = "portalnumero2"
	},
/obj/machinery/light/floor{
	alpha = 0
	},
/turf/open/floor/carpet/red,
/area/wizard_station)
"ZE" = (
/obj/effect/landmark/portal_exit{
	id = "portalnumero15"
	},
/obj/machinery/light/floor{
	alpha = 0
	},
/turf/open/floor/carpet/red,
/area/wizard_station)
"ZQ" = (
/turf/open/space/basic,
/area/space)

(1,1,1) = {"
ZQ
ZQ
ZQ
ZQ
ZQ
ZQ
ZQ
ZQ
ZQ
ZQ
ZQ
ZQ
ZQ
ZQ
ZQ
ZQ
ZQ
ZQ
ZQ
ZQ
ZQ
ZQ
ZQ
ZQ
ZQ
ZQ
ZQ
ZQ
ZQ
ZQ
ZQ
ZQ
ZQ
ZQ
ZQ
ZQ
ZQ
ZQ
ZQ
ZQ
ZQ
ZQ
ZQ
ZQ
ZQ
ZQ
ZQ
ZQ
ZQ
ZQ
ZQ
ZQ
ZQ
ZQ
ZQ
ZQ
ZQ
ZQ
ZQ
ZQ
ZQ
ZQ
ZQ
ZQ
"}
(2,1,1) = {"
ZQ
ZQ
ZQ
ZQ
ZQ
ZQ
ZQ
ZQ
ZQ
ZQ
ZQ
ZQ
ZQ
ZQ
ZQ
ZQ
ZQ
ZQ
ZQ
ZQ
ZQ
ZQ
ZQ
ZQ
ZQ
ZQ
ZQ
ZQ
ZQ
ZQ
ZQ
ZQ
ZQ
ZQ
ZQ
ZQ
ZQ
ZQ
ZQ
ZQ
ZQ
ZQ
ZQ
ZQ
ZQ
ZQ
ZQ
ZQ
ZQ
ZQ
ZQ
ZQ
ZQ
ZQ
ZQ
ZQ
ZQ
ZQ
ZQ
ZQ
ZQ
ZQ
ZQ
ZQ
"}
(3,1,1) = {"
ZQ
ZQ
ZQ
ZQ
ZQ
ZQ
ZQ
ZQ
ZQ
ZQ
ZQ
ZQ
ZQ
ZQ
ZQ
ZQ
ZQ
ZQ
ZQ
ZQ
ZQ
ZQ
ZQ
ZQ
ZQ
ZQ
ZQ
ZQ
ZQ
ZQ
ZQ
ZQ
ZQ
ZQ
ZQ
ZQ
ZQ
ZQ
ZQ
ZQ
ZQ
ZQ
ZQ
ZQ
ZQ
ZQ
ZQ
ZQ
ZQ
ZQ
ZQ
ZQ
ZQ
ZQ
ZQ
ZQ
ZQ
ZQ
ZQ
ZQ
ZQ
ZQ
ZQ
ZQ
"}
(4,1,1) = {"
ZQ
ZQ
ZQ
ZQ
ZQ
ZQ
ZQ
ZQ
ZQ
ZQ
ZQ
ZQ
ZQ
ZQ
ZQ
ZQ
ZQ
ZQ
ZQ
ZQ
ZQ
ZQ
ZQ
ZQ
ZQ
ZQ
ZQ
ZQ
ZQ
ZQ
ZQ
ZQ
ZQ
ZQ
ZQ
ZQ
ZQ
ZQ
ZQ
ZQ
ZQ
ZQ
ZQ
ZQ
ZQ
ZQ
ZQ
ZQ
ZQ
ZQ
ZQ
ZQ
ZQ
ZQ
ZQ
ZQ
ZQ
ZQ
ZQ
ZQ
ZQ
ZQ
ZQ
ZQ
"}
(5,1,1) = {"
ZQ
ZQ
ZQ
ZQ
ZQ
ZQ
ZQ
ZQ
ZQ
ZQ
ZQ
ZQ
ZQ
ZQ
ZQ
ZQ
ZQ
ZQ
ZQ
ZQ
ZQ
ZQ
ZQ
ZQ
ZQ
ZQ
ZQ
ZQ
ZQ
ZQ
ZQ
ZQ
ZQ
ZQ
ZQ
ZQ
ZQ
ZQ
ZQ
ZQ
ZQ
ZQ
ZQ
ZQ
ZQ
ZQ
ZQ
ZQ
ZQ
ZQ
ZQ
ZQ
ZQ
ZQ
ZQ
ZQ
ZQ
ZQ
ZQ
ZQ
ZQ
ZQ
ZQ
ZQ
"}
(6,1,1) = {"
ZQ
ZQ
ZQ
ZQ
ZQ
ZQ
ZQ
ZQ
ZQ
ZQ
ZQ
ZQ
ZQ
ZQ
ZQ
ZQ
ZQ
ZQ
ZQ
ZQ
ZQ
ZQ
ZQ
ZQ
ZQ
ZQ
ZQ
ZQ
ZQ
ZQ
ZQ
ZQ
ZQ
ZQ
ZQ
ZQ
ZQ
ZQ
ZQ
ZQ
ZQ
ZQ
ZQ
ZQ
ZQ
ZQ
ZQ
ZQ
ZQ
ZQ
ZQ
ZQ
ZQ
ZQ
ZQ
ZQ
ZQ
ZQ
ZQ
ZQ
ZQ
ZQ
ZQ
ZQ
"}
(7,1,1) = {"
ZQ
ZQ
ZQ
ZQ
ZQ
ZQ
ZQ
ZQ
ZQ
ZQ
ZQ
ZQ
ZQ
ZQ
ZQ
ZQ
ZQ
ZQ
ZQ
ZQ
ZQ
ZQ
ZQ
ZQ
ZQ
ZQ
ZQ
ZQ
ZQ
ZQ
ZQ
ZQ
ZQ
ZQ
ZQ
ZQ
ZQ
ZQ
ZQ
ZQ
ZQ
ZQ
ZQ
ZQ
ZQ
ZQ
ZQ
ZQ
ZQ
ZQ
ZQ
ZQ
ZQ
ZQ
ZQ
ZQ
ZQ
ZQ
ZQ
ZQ
ZQ
ZQ
ZQ
ZQ
"}
(8,1,1) = {"
ZQ
ZQ
ZQ
ZQ
ZQ
ZQ
ZQ
ZQ
ZQ
ZQ
ZQ
ZQ
ZQ
ZQ
ZQ
ZQ
ZQ
ZQ
ZQ
ZQ
ZQ
ZQ
ZQ
ZQ
ZQ
ZQ
ZQ
ZQ
ZQ
ZQ
ZQ
ZQ
ZQ
ZQ
ZQ
ZQ
ZQ
ZQ
ZQ
ZQ
ZQ
ZQ
ZQ
ZQ
ZQ
ZQ
ZQ
ZQ
ZQ
ZQ
ZQ
ZQ
ZQ
ZQ
ZQ
ZQ
ZQ
ZQ
ZQ
ZQ
ZQ
ZQ
ZQ
ZQ
"}
(9,1,1) = {"
ZQ
ZQ
ZQ
ZQ
ZQ
ZQ
ZQ
ZQ
ZQ
ZQ
ZQ
ZQ
ZQ
ZQ
ZQ
ZQ
ZQ
ZQ
ZQ
ZQ
ZQ
ZQ
ZQ
ZQ
ZQ
ZQ
ZQ
ZQ
ZQ
ZQ
ZQ
ZQ
ZQ
ZQ
ZQ
ZQ
ZQ
ZQ
ZQ
ZQ
ZQ
ZQ
ZQ
ZQ
ZQ
ZQ
ZQ
ZQ
ZQ
ZQ
ZQ
ZQ
ZQ
ZQ
ZQ
ZQ
ZQ
ZQ
ZQ
ZQ
ZQ
ZQ
ZQ
ZQ
"}
(10,1,1) = {"
ZQ
ZQ
ZQ
ZQ
ZQ
ZQ
ZQ
ZQ
ZQ
ZQ
ZQ
ZQ
ZQ
ZQ
ZQ
ZQ
ZQ
ZQ
ZQ
ZQ
ZQ
ZQ
ZQ
ZQ
ZQ
ZQ
ZQ
ZQ
ZQ
ZQ
ZQ
ZQ
ZQ
ZQ
ZQ
ZQ
ZQ
ZQ
ZQ
ZQ
ZQ
ZQ
ZQ
ZQ
ZQ
ZQ
ZQ
ZQ
ZQ
ZQ
ZQ
ZQ
ZQ
ZQ
ZQ
ZQ
ZQ
ZQ
ZQ
ZQ
ZQ
ZQ
ZQ
ZQ
"}
(11,1,1) = {"
ZQ
ZQ
ZQ
ZQ
ZQ
ZQ
ZQ
ZQ
ZQ
ZQ
ZQ
ZQ
ZQ
ZQ
ZQ
ZQ
ZQ
ZQ
ZQ
ZQ
ZQ
ZQ
ZQ
ZQ
ZQ
ZQ
ZQ
ZQ
ZQ
ZQ
ZQ
ZQ
ZQ
ZQ
ZQ
ZQ
ZQ
ZQ
ZQ
ZQ
ZQ
ZQ
ZQ
ZQ
ZQ
ZQ
ZQ
ZQ
ZQ
ZQ
ZQ
ZQ
ZQ
ZQ
ZQ
ZQ
ZQ
ZQ
ZQ
ZQ
ZQ
ZQ
ZQ
ZQ
"}
(12,1,1) = {"
ZQ
ZQ
ZQ
ZQ
ZQ
ZQ
ZQ
ZQ
ZQ
ZQ
ZQ
ZQ
ZQ
ZQ
ZQ
ZQ
ZQ
ZQ
ZQ
ZQ
ZQ
ZQ
ZQ
ZQ
ZQ
ZQ
ZQ
ZQ
ZQ
ZQ
ZQ
ZQ
ZQ
ZQ
ZQ
ZQ
ZQ
ZQ
ZQ
ZQ
ZQ
ZQ
ZQ
ZQ
ZQ
ZQ
ZQ
ZQ
ZQ
ZQ
ZQ
ZQ
ZQ
ZQ
ZQ
ZQ
ZQ
ZQ
ZQ
ZQ
ZQ
ZQ
ZQ
ZQ
"}
(13,1,1) = {"
ZQ
ZQ
ZQ
ZQ
ZQ
ZQ
ZQ
ZQ
ZQ
ZQ
ZQ
ZQ
ZQ
ZQ
ZQ
ZQ
ZQ
ZQ
ZQ
ZQ
ZQ
ZQ
ZQ
ZQ
ZQ
ZQ
ZQ
ZQ
ZQ
ZQ
ZQ
ZQ
ZQ
ZQ
ZQ
ZQ
ZQ
ZQ
ZQ
ZQ
ZQ
ZQ
ZQ
ZQ
ZQ
ZQ
ZQ
ZQ
ZQ
ZQ
ZQ
ZQ
ZQ
ZQ
ZQ
ZQ
ZQ
ZQ
ZQ
ZQ
ZQ
ZQ
ZQ
ZQ
"}
(14,1,1) = {"
ZQ
ZQ
ZQ
ZQ
ZQ
ZQ
ZQ
ZQ
ZQ
ZQ
ZQ
ZQ
ZQ
ZQ
ZQ
ZQ
ZQ
ZQ
ZQ
ZQ
ZQ
ZQ
ZQ
ZQ
ZQ
ZQ
ZQ
ZQ
ZQ
ZQ
ZQ
ZQ
ZQ
ZQ
ZQ
ZQ
ZQ
ZQ
ZQ
ZQ
ZQ
ZQ
ZQ
ZQ
ZQ
ZQ
ZQ
ZQ
ZQ
ZQ
ZQ
ZQ
ZQ
ZQ
ZQ
ZQ
ZQ
ZQ
ZQ
ZQ
ZQ
ZQ
ZQ
ZQ
"}
(15,1,1) = {"
ZQ
ZQ
ZQ
ZQ
ZQ
ZQ
ZQ
ZQ
ZQ
ZQ
ZQ
ZQ
ZQ
ZQ
ZQ
ZQ
ZQ
ZQ
ZQ
ZQ
ZQ
ZQ
ZQ
ZQ
ZQ
ZQ
ZQ
ZQ
ZQ
ZQ
ZQ
ZQ
ZQ
ZQ
ZQ
ZQ
ZQ
ZQ
ZQ
ZQ
ZQ
ZQ
ZQ
ZQ
ZQ
ZQ
ZQ
ZQ
ZQ
ZQ
ZQ
ZQ
ZQ
ZQ
ZQ
ZQ
ZQ
ZQ
ZQ
ZQ
ZQ
ZQ
ZQ
ZQ
"}
(16,1,1) = {"
ZQ
ZQ
ZQ
ZQ
ZQ
ZQ
ZQ
ZQ
ZQ
ZQ
ZQ
ZQ
ZQ
ZQ
ZQ
ZQ
ZQ
XD
ZQ
ZQ
ZQ
ZQ
ZQ
ZQ
ZQ
ZQ
ZQ
ZQ
ZQ
ZQ
ZQ
ZQ
ZQ
ZQ
ZQ
ZQ
ZQ
ZQ
ZQ
ZQ
ZQ
ZQ
ZQ
ZQ
ZQ
ZQ
ZQ
ZQ
ZQ
ZQ
ZQ
ZQ
ZQ
ZQ
ZQ
ZQ
ZQ
ZQ
ZQ
ZQ
ZQ
ZQ
ZQ
ZQ
"}
(17,1,1) = {"
ZQ
ZQ
ZQ
ZQ
ZQ
ZQ
ZQ
ZQ
ZQ
ZQ
ZQ
ZQ
ZQ
ZQ
wO
wO
wO
wO
wO
wO
wO
ZQ
ZQ
ZQ
ZQ
ZQ
ZQ
ZQ
ZQ
ZQ
ZQ
ZQ
ZQ
ZQ
ZQ
ZQ
ZQ
ZQ
ZQ
ZQ
ZQ
ZQ
ZQ
ZQ
ZQ
ZQ
ZQ
ZQ
ZQ
ZQ
ZQ
ZQ
ZQ
ZQ
ZQ
ZQ
ZQ
ZQ
ZQ
ZQ
ZQ
ZQ
ZQ
ZQ
"}
(18,1,1) = {"
ZQ
ZQ
ZQ
ZQ
ZQ
ZQ
ZQ
ZQ
ZQ
ZQ
ZQ
wO
wO
wO
wO
wO
wO
wO
wO
wO
wO
wO
wO
wO
ZQ
ZQ
ZQ
ZQ
ZQ
ZQ
ZQ
ZQ
ZQ
ZQ
ZQ
ZQ
ZQ
ZQ
ZQ
ZQ
ZQ
ZQ
ZQ
ZQ
ZQ
ZQ
ZQ
ZQ
ZQ
ZQ
ZQ
ZQ
ZQ
ZQ
ZQ
ZQ
ZQ
ZQ
ZQ
ZQ
ZQ
ZQ
ZQ
ZQ
"}
(19,1,1) = {"
ZQ
ZQ
ZQ
ZQ
ZQ
ZQ
ZQ
ZQ
ZQ
wO
wO
wO
wO
wO
wO
wO
wO
wO
wO
wO
wO
wO
wO
wO
wO
wO
ZQ
ZQ
ZQ
ZQ
ZQ
ZQ
ZQ
ZQ
ZQ
ZQ
ZQ
ZQ
ZQ
ZQ
ZQ
ZQ
ZQ
ZQ
ZQ
ZQ
ZQ
ZQ
ZQ
ZQ
ZQ
ZQ
ZQ
ZQ
ZQ
ZQ
ZQ
ZQ
ZQ
ZQ
ZQ
ZQ
ZQ
ZQ
"}
(20,1,1) = {"
ZQ
ZQ
ZQ
ZQ
ZQ
ZQ
ZQ
ZQ
wO
wO
wO
wO
wO
wO
wO
wO
wO
wO
wO
wO
wO
wO
wO
wO
wO
wO
wO
ZQ
ZQ
ZQ
ZQ
ZQ
ZQ
ZQ
ZQ
ZQ
ZQ
ZQ
ZQ
ZQ
ZQ
ZQ
ZQ
ZQ
ZQ
ZQ
ZQ
ZQ
ZQ
ZQ
ZQ
ZQ
ZQ
ZQ
ZQ
ZQ
ZQ
ZQ
ZQ
ZQ
ZQ
ZQ
ZQ
ZQ
"}
(21,1,1) = {"
ZQ
ZQ
ZQ
ZQ
ZQ
ZQ
ZQ
wO
wO
wO
wO
fb
jA
hd
wO
vM
jA
vM
wO
Nn
jA
Nn
wO
qu
jA
HF
wO
wO
ZQ
ZQ
ZQ
ZQ
ZQ
ZQ
ZQ
ZQ
ZQ
ZQ
ZQ
ZQ
ZQ
ZQ
ZQ
ZQ
ZQ
ZQ
ZQ
ZQ
ZQ
ZQ
ZQ
ZQ
ZQ
ZQ
ZQ
ZQ
ZQ
ZQ
ZQ
ZQ
ZQ
ZQ
ZQ
ZQ
"}
(22,1,1) = {"
ZQ
ZQ
ZQ
ZQ
ZQ
ZQ
wO
wO
wO
wO
wO
jA
LK
jA
wO
jA
gr
jA
wO
jA
Qj
jA
wO
jA
vs
jA
wO
wO
wO
ZQ
ZQ
ZQ
ZQ
ZQ
ZQ
ZQ
ZQ
ZQ
ZQ
ZQ
ZQ
ZQ
ZQ
ZQ
ZQ
ZQ
ZQ
ZQ
ZQ
ZQ
ZQ
ZQ
ZQ
ZQ
ZQ
ZQ
ZQ
ZQ
ZQ
ZQ
ZQ
ZQ
ZQ
ZQ
"}
(23,1,1) = {"
ZQ
ZQ
ZQ
ZQ
ZQ
wO
wO
wO
wO
wO
wO
fb
jA
fb
wO
hf
jA
vM
wO
IL
jA
Nn
wO
HF
jA
HF
wO
wO
wO
wO
ZQ
ZQ
ZQ
ZQ
ZQ
ZQ
ZQ
ZQ
ZQ
ZQ
ZQ
ZQ
ZQ
ZQ
ZQ
ZQ
ZQ
ZQ
ZQ
ZQ
ZQ
ZQ
ZQ
ZQ
ZQ
ZQ
ZQ
ZQ
ZQ
ZQ
ZQ
ZQ
ZQ
ZQ
"}
(24,1,1) = {"
ZQ
ZQ
ZQ
ZQ
wO
wO
wO
wO
wO
wO
wO
wO
wO
wO
wO
wO
wO
wO
wO
wO
wO
wO
wO
wO
wO
wO
wO
wO
wO
wO
wO
ZQ
ZQ
ZQ
ZQ
ZQ
ZQ
ZQ
ZQ
ZQ
ZQ
ZQ
ZQ
ZQ
ZQ
ZQ
ZQ
ZQ
ZQ
ZQ
ZQ
ZQ
ZQ
ZQ
ZQ
ZQ
ZQ
ZQ
ZQ
ZQ
ZQ
ZQ
ZQ
ZQ
"}
(25,1,1) = {"
ZQ
ZQ
ZQ
ZQ
wO
wO
wO
Mr
jA
tK
wO
ix
jA
oZ
wO
bb
jA
Mu
wO
KE
jA
Gy
wO
oy
jA
oy
wO
vk
jA
oy
wO
ZQ
ZQ
ZQ
ZQ
ZQ
ZQ
ZQ
ZQ
ZQ
ZQ
ZQ
ZQ
ZQ
ZQ
ZQ
ZQ
ZQ
ZQ
ZQ
ZQ
ZQ
ZQ
ZQ
ZQ
ZQ
ZQ
ZQ
ZQ
ZQ
ZQ
ZQ
ZQ
ZQ
"}
(26,1,1) = {"
ZQ
ZQ
ZQ
wO
wO
wO
wO
jA
MP
jA
wO
jA
aZ
jA
wO
jA
bB
jA
wO
jA
zu
jA
wO
jA
yw
jA
wO
jA
mI
jA
wO
wO
ZQ
ZQ
ZQ
ZQ
ZQ
ZQ
ZQ
ZQ
ZQ
ZQ
ZQ
ZQ
ZQ
ZQ
ZQ
ZQ
ZQ
ZQ
ZQ
ZQ
ZQ
ZQ
ZQ
ZQ
ZQ
ZQ
ZQ
ZQ
ZQ
ZQ
ZQ
ZQ
"}
(27,1,1) = {"
ZQ
ZQ
ZQ
wO
wO
wO
wO
tK
jA
tK
wO
oZ
jA
oZ
wO
bb
jA
bb
wO
KE
jA
KE
wO
oy
jA
ST
wO
vk
jA
vk
wO
wO
ZQ
ZQ
ZQ
ZQ
ZQ
ZQ
ZQ
ZQ
ZQ
ZQ
ZQ
ZQ
ZQ
ZQ
ZQ
ZQ
ZQ
ZQ
ZQ
ZQ
ZQ
ZQ
ZQ
ZQ
ZQ
ZQ
ZQ
ZQ
ZQ
ZQ
ZQ
ZQ
"}
(28,1,1) = {"
ZQ
ZQ
ZQ
wO
wO
wO
wO
wO
wO
wO
wO
wO
wO
wO
wO
wO
wO
wO
wO
wO
wO
wO
wO
wO
wO
wO
wO
wO
wO
wO
wO
wO
ZQ
ZQ
ZQ
ZQ
ZQ
ZQ
ZQ
ZQ
ZQ
ZQ
ZQ
ZQ
ZQ
ZQ
ZQ
ZQ
ZQ
ZQ
ZQ
ZQ
ZQ
ZQ
ZQ
ZQ
ZQ
ZQ
ZQ
ZQ
ZQ
ZQ
ZQ
ZQ
"}
(29,1,1) = {"
ZQ
ZQ
wO
wO
LL
jA
LL
wO
WB
jA
Nu
wO
Dm
IF
IF
IF
IF
IF
Ed
wO
KI
jA
IL
wO
qu
jA
qu
wO
Dr
Dr
Dr
wO
wO
ZQ
ZQ
ZQ
ZQ
ZQ
ZQ
ZQ
ZQ
ZQ
ZQ
ZQ
ZQ
ZQ
ZQ
ZQ
ZQ
ZQ
ZQ
ZQ
ZQ
ZQ
ZQ
ZQ
ZQ
ZQ
ZQ
ZQ
ZQ
ZQ
ZQ
ZQ
"}
(30,1,1) = {"
ZQ
ZQ
wO
wO
jA
XP
jA
wO
jA
DG
jA
wO
IF
GL
IF
IF
IF
GL
IF
wO
jA
aV
jA
wO
jA
TG
jA
wO
GE
eF
uy
wO
wO
ZQ
ZQ
ZQ
ZQ
ZQ
ZQ
ZQ
ZQ
ZQ
ZQ
ZQ
ZQ
ZQ
ZQ
ZQ
ZQ
ZQ
ZQ
ZQ
ZQ
ZQ
ZQ
ZQ
ZQ
ZQ
ZQ
ZQ
ZQ
ZQ
ZQ
ZQ
"}
(31,1,1) = {"
ZQ
ZQ
wO
wO
wC
jA
LL
wO
Nu
jA
Nu
wO
IF
IF
IF
za
IF
IF
IF
wO
IL
jA
IL
wO
qu
jA
nO
wO
Dr
Dr
Dr
wO
wO
ZQ
ZQ
ZQ
ZQ
ZQ
ZQ
ZQ
ZQ
ZQ
ZQ
ZQ
ZQ
ZQ
ZQ
ZQ
ZQ
ZQ
ZQ
ZQ
ZQ
ZQ
ZQ
ZQ
ZQ
ZQ
ZQ
ZQ
ZQ
ZQ
ZQ
ZQ
"}
(32,1,1) = {"
ZQ
yd
wO
wO
wO
wO
wO
wO
wO
wO
wO
wO
jU
IF
IF
tV
IF
IF
XJ
wO
wO
wO
wO
wO
wO
wO
wO
wO
wO
wO
wO
wO
wO
XD
ZQ
ZQ
ZQ
ZQ
ZQ
ZQ
ZQ
ZQ
ZQ
ZQ
ZQ
ZQ
ZQ
ZQ
ZQ
ZQ
ZQ
ZQ
ZQ
ZQ
ZQ
ZQ
ZQ
ZQ
ZQ
ZQ
ZQ
ZQ
ZQ
ZQ
"}
(33,1,1) = {"
ZQ
ZQ
wO
wO
iH
jA
BD
wO
Mr
jA
Mr
wO
IF
IF
IF
za
IF
IF
IF
wO
ub
jA
Gy
wO
vY
jA
ST
wO
Ne
jA
Ne
wO
wO
ZQ
ZQ
ZQ
ZQ
ZQ
ZQ
ZQ
ZQ
ZQ
ZQ
ZQ
ZQ
ZQ
ZQ
ZQ
ZQ
ZQ
ZQ
ZQ
ZQ
ZQ
ZQ
ZQ
ZQ
ZQ
ZQ
ZQ
ZQ
ZQ
ZQ
ZQ
"}
(34,1,1) = {"
ZQ
ZQ
wO
wO
jA
Ap
jA
wO
jA
hh
jA
wO
IF
GL
IF
IF
IF
GL
IF
wO
jA
vb
jA
wO
jA
AL
jA
wO
jA
Id
jA
wO
wO
ZQ
ZQ
ZQ
ZQ
ZQ
ZQ
ZQ
ZQ
ZQ
ZQ
ZQ
ZQ
ZQ
ZQ
ZQ
ZQ
ZQ
ZQ
ZQ
ZQ
ZQ
ZQ
ZQ
ZQ
ZQ
ZQ
ZQ
ZQ
ZQ
ZQ
ZQ
"}
(35,1,1) = {"
ZQ
ZQ
wO
wO
iH
jA
iH
wO
Mr
jA
LL
wO
Dm
IF
IF
IF
IF
IF
qS
wO
Gy
jA
Gy
wO
ST
jA
ST
wO
vk
jA
Ne
wO
wO
ZQ
ZQ
ZQ
ZQ
ZQ
ZQ
ZQ
ZQ
ZQ
ZQ
ZQ
ZQ
ZQ
ZQ
ZQ
ZQ
ZQ
ZQ
ZQ
ZQ
ZQ
ZQ
ZQ
ZQ
ZQ
ZQ
ZQ
ZQ
ZQ
ZQ
ZQ
"}
(36,1,1) = {"
ZQ
ZQ
ZQ
wO
wO
wO
wO
wO
wO
wO
wO
wO
wO
wO
wO
wO
wO
wO
wO
wO
wO
wO
wO
wO
wO
wO
wO
wO
wO
wO
wO
wO
ZQ
ZQ
ZQ
ZQ
ZQ
ZQ
ZQ
ZQ
ZQ
ZQ
ZQ
ZQ
ZQ
ZQ
ZQ
ZQ
ZQ
ZQ
ZQ
ZQ
ZQ
ZQ
ZQ
ZQ
ZQ
ZQ
ZQ
ZQ
ZQ
ZQ
ZQ
ZQ
"}
(37,1,1) = {"
ZQ
ZQ
ZQ
wO
wO
wO
wO
WB
jA
iH
wO
hd
jA
hd
wO
fb
jA
hf
wO
KI
jA
KI
wO
nO
jA
nO
wO
Ga
jA
Ga
wO
wO
ZQ
ZQ
ZQ
ZQ
ZQ
ZQ
ZQ
ZQ
ZQ
ZQ
ZQ
ZQ
ZQ
ZQ
ZQ
ZQ
ZQ
ZQ
ZQ
ZQ
ZQ
ZQ
ZQ
ZQ
ZQ
ZQ
ZQ
ZQ
ZQ
ZQ
ZQ
ZQ
"}
(38,1,1) = {"
ZQ
ZQ
ZQ
wO
wO
wO
wO
jA
HN
jA
wO
jA
DC
jA
wO
jA
fw
jA
wO
jA
MX
jA
wO
jA
jX
jA
wO
jA
Yx
jA
wO
wO
ZQ
ZQ
ZQ
ZQ
ZQ
ZQ
ZQ
ZQ
ZQ
ZQ
ZQ
ZQ
ZQ
ZQ
ZQ
ZQ
ZQ
ZQ
ZQ
ZQ
ZQ
ZQ
ZQ
ZQ
ZQ
ZQ
ZQ
ZQ
ZQ
ZQ
ZQ
ZQ
"}
(39,1,1) = {"
ZQ
ZQ
ZQ
ZQ
wO
wO
wO
WB
jA
WB
wO
hd
jA
tK
wO
hf
jA
hf
wO
KI
jA
vM
wO
Nn
jA
nO
wO
HF
jA
Ga
wO
ZQ
ZQ
ZQ
ZQ
ZQ
ZQ
ZQ
ZQ
ZQ
ZQ
ZQ
ZQ
ZQ
ZQ
ZQ
ZQ
ZQ
ZQ
ZQ
ZQ
ZQ
ZQ
ZQ
ZQ
ZQ
ZQ
ZQ
ZQ
ZQ
ZQ
ZQ
ZQ
ZQ
"}
(40,1,1) = {"
ZQ
ZQ
ZQ
ZQ
wO
wO
wO
wO
wO
wO
wO
wO
wO
wO
wO
wO
wO
wO
wO
wO
wO
wO
wO
wO
wO
wO
wO
wO
wO
wO
wO
ZQ
ZQ
ZQ
ZQ
ZQ
ZQ
ZQ
ZQ
ZQ
ZQ
ZQ
ZQ
ZQ
ZQ
ZQ
ZQ
ZQ
ZQ
ZQ
ZQ
ZQ
ZQ
ZQ
ZQ
ZQ
ZQ
ZQ
ZQ
ZQ
ZQ
ZQ
ZQ
ZQ
"}
(41,1,1) = {"
ZQ
ZQ
ZQ
ZQ
ZQ
wO
wO
wO
wO
wO
wO
Nu
jA
ix
wO
Mu
jA
Mu
wO
ub
jA
ub
wO
vY
jA
vY
wO
wO
wO
wO
ZQ
ZQ
ZQ
ZQ
ZQ
ZQ
ZQ
ZQ
ZQ
ZQ
ZQ
ZQ
ZQ
ZQ
ZQ
ZQ
ZQ
ZQ
ZQ
ZQ
ZQ
ZQ
ZQ
ZQ
ZQ
ZQ
ZQ
ZQ
ZQ
ZQ
ZQ
ZQ
ZQ
ZQ
"}
(42,1,1) = {"
ZQ
ZQ
ZQ
ZQ
ZQ
ZQ
wO
wO
wO
wO
wO
jA
vJ
jA
wO
jA
Ck
jA
wO
jA
ZE
jA
wO
jA
aI
jA
wO
wO
wO
ZQ
ZQ
ZQ
ZQ
ZQ
ZQ
ZQ
ZQ
ZQ
ZQ
ZQ
ZQ
ZQ
ZQ
ZQ
ZQ
ZQ
ZQ
ZQ
ZQ
ZQ
ZQ
ZQ
ZQ
ZQ
ZQ
ZQ
ZQ
ZQ
ZQ
ZQ
ZQ
ZQ
ZQ
ZQ
"}
(43,1,1) = {"
ZQ
ZQ
ZQ
ZQ
ZQ
ZQ
ZQ
wO
wO
wO
wO
ix
jA
ix
wO
oZ
jA
Mu
wO
ub
jA
bb
wO
vY
jA
KE
wO
wO
ZQ
ZQ
ZQ
ZQ
ZQ
ZQ
ZQ
ZQ
ZQ
ZQ
ZQ
ZQ
ZQ
ZQ
ZQ
ZQ
ZQ
ZQ
ZQ
ZQ
ZQ
ZQ
ZQ
ZQ
ZQ
ZQ
ZQ
ZQ
ZQ
ZQ
ZQ
ZQ
ZQ
ZQ
ZQ
ZQ
"}
(44,1,1) = {"
ZQ
ZQ
ZQ
ZQ
ZQ
ZQ
ZQ
ZQ
wO
wO
wO
wO
wO
wO
wO
wO
wO
wO
wO
wO
wO
wO
wO
wO
wO
wO
wO
ZQ
ZQ
ZQ
ZQ
ZQ
ZQ
ZQ
ZQ
ZQ
ZQ
ZQ
ZQ
ZQ
ZQ
ZQ
ZQ
ZQ
ZQ
ZQ
ZQ
ZQ
ZQ
ZQ
ZQ
ZQ
ZQ
ZQ
ZQ
ZQ
ZQ
ZQ
ZQ
ZQ
ZQ
ZQ
ZQ
ZQ
"}
(45,1,1) = {"
ZQ
ZQ
ZQ
ZQ
ZQ
ZQ
ZQ
ZQ
ZQ
wO
wO
wO
wO
wO
wO
wO
wO
wO
wO
wO
wO
wO
wO
wO
wO
wO
ZQ
ZQ
ZQ
ZQ
ZQ
ZQ
ZQ
ZQ
ZQ
ZQ
ZQ
ZQ
ZQ
ZQ
ZQ
ZQ
ZQ
ZQ
ZQ
ZQ
ZQ
ZQ
ZQ
ZQ
ZQ
ZQ
ZQ
ZQ
ZQ
ZQ
ZQ
ZQ
ZQ
ZQ
ZQ
ZQ
ZQ
ZQ
"}
(46,1,1) = {"
ZQ
ZQ
ZQ
ZQ
ZQ
ZQ
ZQ
ZQ
ZQ
ZQ
ZQ
wO
wO
wO
wO
wO
wO
wO
wO
wO
wO
wO
wO
wO
ZQ
ZQ
ZQ
ZQ
ZQ
ZQ
ZQ
ZQ
ZQ
ZQ
ZQ
ZQ
ZQ
ZQ
ZQ
ZQ
ZQ
ZQ
ZQ
ZQ
ZQ
ZQ
ZQ
ZQ
ZQ
ZQ
ZQ
ZQ
ZQ
ZQ
ZQ
ZQ
ZQ
ZQ
ZQ
ZQ
ZQ
ZQ
ZQ
ZQ
"}
(47,1,1) = {"
ZQ
ZQ
ZQ
ZQ
ZQ
ZQ
ZQ
ZQ
ZQ
ZQ
ZQ
ZQ
ZQ
ZQ
wO
wO
wO
wO
wO
wO
wO
ZQ
ZQ
ZQ
ZQ
ZQ
ZQ
ZQ
ZQ
ZQ
ZQ
ZQ
ZQ
ZQ
ZQ
ZQ
ZQ
ZQ
ZQ
ZQ
ZQ
ZQ
ZQ
ZQ
ZQ
ZQ
ZQ
ZQ
ZQ
ZQ
ZQ
ZQ
ZQ
ZQ
ZQ
ZQ
ZQ
ZQ
ZQ
ZQ
ZQ
ZQ
ZQ
ZQ
"}
(48,1,1) = {"
ZQ
ZQ
ZQ
ZQ
ZQ
ZQ
ZQ
ZQ
ZQ
ZQ
ZQ
ZQ
ZQ
ZQ
ZQ
ZQ
ZQ
XD
ZQ
ZQ
ZQ
ZQ
ZQ
ZQ
ZQ
ZQ
ZQ
ZQ
ZQ
ZQ
ZQ
ZQ
ZQ
ZQ
ZQ
ZQ
ZQ
ZQ
ZQ
ZQ
ZQ
ZQ
ZQ
ZQ
ZQ
ZQ
ZQ
ZQ
ZQ
ZQ
ZQ
ZQ
ZQ
ZQ
ZQ
ZQ
ZQ
ZQ
ZQ
ZQ
ZQ
ZQ
ZQ
ZQ
"}
(49,1,1) = {"
ZQ
ZQ
ZQ
ZQ
ZQ
ZQ
ZQ
ZQ
ZQ
ZQ
ZQ
ZQ
ZQ
ZQ
ZQ
ZQ
ZQ
ZQ
ZQ
ZQ
ZQ
ZQ
ZQ
ZQ
ZQ
ZQ
ZQ
ZQ
ZQ
ZQ
ZQ
ZQ
ZQ
ZQ
ZQ
ZQ
ZQ
ZQ
ZQ
ZQ
ZQ
ZQ
ZQ
ZQ
ZQ
ZQ
ZQ
ZQ
ZQ
ZQ
ZQ
ZQ
ZQ
ZQ
ZQ
ZQ
ZQ
ZQ
ZQ
ZQ
ZQ
ZQ
ZQ
ZQ
"}
(50,1,1) = {"
ZQ
ZQ
ZQ
ZQ
ZQ
ZQ
ZQ
ZQ
ZQ
ZQ
ZQ
ZQ
ZQ
ZQ
ZQ
ZQ
ZQ
ZQ
ZQ
ZQ
ZQ
ZQ
ZQ
ZQ
ZQ
ZQ
ZQ
ZQ
ZQ
ZQ
ZQ
ZQ
ZQ
ZQ
ZQ
ZQ
ZQ
ZQ
ZQ
ZQ
ZQ
ZQ
ZQ
ZQ
ZQ
ZQ
ZQ
ZQ
ZQ
ZQ
ZQ
ZQ
ZQ
ZQ
ZQ
ZQ
ZQ
ZQ
ZQ
ZQ
ZQ
ZQ
ZQ
ZQ
"}
(51,1,1) = {"
ZQ
ZQ
ZQ
ZQ
ZQ
ZQ
ZQ
ZQ
ZQ
ZQ
ZQ
ZQ
ZQ
ZQ
ZQ
ZQ
ZQ
ZQ
ZQ
ZQ
ZQ
ZQ
ZQ
ZQ
ZQ
ZQ
ZQ
ZQ
ZQ
ZQ
ZQ
ZQ
ZQ
ZQ
ZQ
ZQ
ZQ
ZQ
ZQ
ZQ
ZQ
ZQ
ZQ
ZQ
ZQ
ZQ
ZQ
ZQ
ZQ
ZQ
ZQ
ZQ
ZQ
ZQ
ZQ
ZQ
ZQ
ZQ
ZQ
ZQ
ZQ
ZQ
ZQ
ZQ
"}
(52,1,1) = {"
ZQ
ZQ
ZQ
ZQ
ZQ
ZQ
ZQ
ZQ
ZQ
ZQ
ZQ
ZQ
ZQ
ZQ
ZQ
ZQ
ZQ
ZQ
ZQ
ZQ
ZQ
ZQ
ZQ
ZQ
ZQ
ZQ
ZQ
ZQ
ZQ
ZQ
ZQ
ZQ
ZQ
ZQ
ZQ
ZQ
ZQ
ZQ
ZQ
ZQ
ZQ
ZQ
ZQ
ZQ
ZQ
ZQ
ZQ
ZQ
ZQ
ZQ
ZQ
ZQ
ZQ
ZQ
ZQ
ZQ
ZQ
ZQ
ZQ
ZQ
ZQ
ZQ
ZQ
ZQ
"}
(53,1,1) = {"
ZQ
ZQ
ZQ
ZQ
ZQ
ZQ
ZQ
ZQ
ZQ
ZQ
ZQ
ZQ
ZQ
ZQ
ZQ
ZQ
ZQ
ZQ
ZQ
ZQ
ZQ
ZQ
ZQ
ZQ
ZQ
ZQ
ZQ
ZQ
ZQ
ZQ
ZQ
ZQ
ZQ
ZQ
ZQ
ZQ
ZQ
ZQ
ZQ
ZQ
ZQ
ZQ
ZQ
ZQ
ZQ
ZQ
ZQ
ZQ
ZQ
ZQ
ZQ
ZQ
ZQ
ZQ
ZQ
ZQ
ZQ
ZQ
ZQ
ZQ
ZQ
ZQ
ZQ
ZQ
"}
(54,1,1) = {"
ZQ
ZQ
ZQ
ZQ
ZQ
ZQ
ZQ
ZQ
ZQ
ZQ
ZQ
ZQ
ZQ
ZQ
ZQ
ZQ
ZQ
ZQ
ZQ
ZQ
ZQ
ZQ
ZQ
ZQ
ZQ
ZQ
ZQ
ZQ
ZQ
ZQ
ZQ
ZQ
ZQ
ZQ
ZQ
ZQ
ZQ
ZQ
ZQ
ZQ
ZQ
ZQ
ZQ
ZQ
ZQ
ZQ
ZQ
ZQ
ZQ
ZQ
ZQ
ZQ
ZQ
ZQ
ZQ
ZQ
ZQ
ZQ
ZQ
ZQ
ZQ
ZQ
ZQ
ZQ
"}
(55,1,1) = {"
ZQ
ZQ
ZQ
ZQ
ZQ
ZQ
ZQ
ZQ
ZQ
ZQ
ZQ
ZQ
ZQ
ZQ
ZQ
ZQ
ZQ
ZQ
ZQ
ZQ
ZQ
ZQ
ZQ
ZQ
ZQ
ZQ
ZQ
ZQ
ZQ
ZQ
ZQ
ZQ
ZQ
ZQ
ZQ
ZQ
ZQ
ZQ
ZQ
ZQ
ZQ
ZQ
ZQ
ZQ
ZQ
ZQ
ZQ
ZQ
ZQ
ZQ
ZQ
ZQ
ZQ
ZQ
ZQ
ZQ
ZQ
ZQ
ZQ
ZQ
ZQ
ZQ
ZQ
ZQ
"}
(56,1,1) = {"
ZQ
ZQ
ZQ
ZQ
ZQ
ZQ
ZQ
ZQ
ZQ
ZQ
ZQ
ZQ
ZQ
ZQ
ZQ
ZQ
ZQ
ZQ
ZQ
ZQ
ZQ
ZQ
ZQ
ZQ
ZQ
ZQ
ZQ
ZQ
ZQ
ZQ
ZQ
ZQ
ZQ
ZQ
ZQ
ZQ
ZQ
ZQ
ZQ
ZQ
ZQ
ZQ
ZQ
ZQ
ZQ
ZQ
ZQ
ZQ
ZQ
ZQ
ZQ
ZQ
ZQ
ZQ
ZQ
ZQ
ZQ
ZQ
ZQ
ZQ
ZQ
ZQ
ZQ
ZQ
"}
(57,1,1) = {"
ZQ
ZQ
ZQ
ZQ
ZQ
ZQ
ZQ
ZQ
ZQ
ZQ
ZQ
ZQ
ZQ
ZQ
ZQ
ZQ
ZQ
ZQ
ZQ
ZQ
ZQ
ZQ
ZQ
ZQ
ZQ
ZQ
ZQ
ZQ
ZQ
ZQ
ZQ
ZQ
ZQ
ZQ
ZQ
ZQ
ZQ
ZQ
ZQ
ZQ
ZQ
ZQ
ZQ
ZQ
ZQ
ZQ
ZQ
ZQ
ZQ
ZQ
ZQ
ZQ
ZQ
ZQ
ZQ
ZQ
ZQ
ZQ
ZQ
ZQ
ZQ
ZQ
ZQ
ZQ
"}
(58,1,1) = {"
ZQ
ZQ
ZQ
ZQ
ZQ
ZQ
ZQ
ZQ
ZQ
ZQ
ZQ
ZQ
ZQ
ZQ
ZQ
ZQ
ZQ
ZQ
ZQ
ZQ
ZQ
ZQ
ZQ
ZQ
ZQ
ZQ
ZQ
ZQ
ZQ
ZQ
ZQ
ZQ
ZQ
ZQ
ZQ
ZQ
ZQ
ZQ
ZQ
ZQ
ZQ
ZQ
ZQ
ZQ
ZQ
ZQ
ZQ
ZQ
ZQ
ZQ
ZQ
ZQ
ZQ
ZQ
ZQ
ZQ
ZQ
ZQ
ZQ
ZQ
ZQ
ZQ
ZQ
ZQ
"}
(59,1,1) = {"
ZQ
ZQ
ZQ
ZQ
ZQ
ZQ
ZQ
ZQ
ZQ
ZQ
ZQ
ZQ
ZQ
ZQ
ZQ
ZQ
ZQ
ZQ
ZQ
ZQ
ZQ
ZQ
ZQ
ZQ
ZQ
ZQ
ZQ
ZQ
ZQ
ZQ
ZQ
ZQ
ZQ
ZQ
ZQ
ZQ
ZQ
ZQ
ZQ
ZQ
ZQ
ZQ
ZQ
ZQ
ZQ
ZQ
ZQ
ZQ
ZQ
ZQ
ZQ
ZQ
ZQ
ZQ
ZQ
ZQ
ZQ
ZQ
ZQ
ZQ
ZQ
ZQ
ZQ
ZQ
"}
(60,1,1) = {"
ZQ
ZQ
ZQ
ZQ
ZQ
ZQ
ZQ
ZQ
ZQ
ZQ
ZQ
ZQ
ZQ
ZQ
ZQ
ZQ
ZQ
ZQ
ZQ
ZQ
ZQ
ZQ
ZQ
ZQ
ZQ
ZQ
ZQ
ZQ
ZQ
ZQ
ZQ
ZQ
ZQ
ZQ
ZQ
ZQ
ZQ
ZQ
ZQ
ZQ
ZQ
ZQ
ZQ
ZQ
ZQ
ZQ
ZQ
ZQ
ZQ
ZQ
ZQ
ZQ
ZQ
ZQ
ZQ
ZQ
ZQ
ZQ
ZQ
ZQ
ZQ
ZQ
ZQ
ZQ
"}
(61,1,1) = {"
ZQ
ZQ
ZQ
ZQ
ZQ
ZQ
ZQ
ZQ
ZQ
ZQ
ZQ
ZQ
ZQ
ZQ
ZQ
ZQ
ZQ
ZQ
ZQ
ZQ
ZQ
ZQ
ZQ
ZQ
ZQ
ZQ
ZQ
ZQ
ZQ
ZQ
ZQ
ZQ
ZQ
ZQ
ZQ
ZQ
ZQ
ZQ
ZQ
ZQ
ZQ
ZQ
ZQ
ZQ
ZQ
ZQ
ZQ
ZQ
ZQ
ZQ
ZQ
ZQ
ZQ
ZQ
ZQ
ZQ
ZQ
ZQ
ZQ
ZQ
ZQ
ZQ
ZQ
ZQ
"}
(62,1,1) = {"
ZQ
ZQ
ZQ
ZQ
ZQ
ZQ
ZQ
ZQ
ZQ
ZQ
ZQ
ZQ
ZQ
ZQ
ZQ
ZQ
ZQ
ZQ
ZQ
ZQ
ZQ
ZQ
ZQ
ZQ
ZQ
ZQ
ZQ
ZQ
ZQ
ZQ
ZQ
ZQ
ZQ
ZQ
ZQ
ZQ
ZQ
ZQ
ZQ
ZQ
ZQ
ZQ
ZQ
ZQ
ZQ
ZQ
ZQ
ZQ
ZQ
ZQ
ZQ
ZQ
ZQ
ZQ
ZQ
ZQ
ZQ
ZQ
ZQ
ZQ
ZQ
ZQ
ZQ
ZQ
"}
(63,1,1) = {"
ZQ
ZQ
ZQ
ZQ
ZQ
ZQ
ZQ
ZQ
ZQ
ZQ
ZQ
ZQ
ZQ
ZQ
ZQ
ZQ
ZQ
ZQ
ZQ
ZQ
ZQ
ZQ
ZQ
ZQ
ZQ
ZQ
ZQ
ZQ
ZQ
ZQ
ZQ
ZQ
ZQ
ZQ
ZQ
ZQ
ZQ
ZQ
ZQ
ZQ
ZQ
ZQ
ZQ
ZQ
ZQ
ZQ
ZQ
ZQ
ZQ
ZQ
ZQ
ZQ
ZQ
ZQ
ZQ
ZQ
ZQ
ZQ
ZQ
ZQ
ZQ
ZQ
ZQ
ZQ
"}
(64,1,1) = {"
ZQ
ZQ
ZQ
ZQ
ZQ
ZQ
ZQ
ZQ
ZQ
ZQ
ZQ
ZQ
ZQ
ZQ
ZQ
ZQ
ZQ
ZQ
ZQ
ZQ
ZQ
ZQ
ZQ
ZQ
ZQ
ZQ
ZQ
ZQ
ZQ
ZQ
ZQ
ZQ
ZQ
ZQ
ZQ
ZQ
ZQ
ZQ
ZQ
ZQ
ZQ
ZQ
ZQ
ZQ
ZQ
ZQ
ZQ
ZQ
ZQ
ZQ
ZQ
ZQ
ZQ
ZQ
ZQ
ZQ
ZQ
ZQ
ZQ
ZQ
ZQ
ZQ
ZQ
ZQ
"}
