"aI" = (/obj/effect/landmark/portal_exit{id = portalnumero9},/obj/machinery/light/floor{alpha = 0},/turf/open/floor/carpet/red,/area/wizard_station{name = "Wizard's Unholy Maze"})
"aV" = (/obj/effect/landmark/portal_exit{id = portalnumero12},/obj/machinery/light/floor{alpha = 0},/turf/open/floor/carpet/red,/area/wizard_station{name = "Wizard's Unholy Maze"})
"aZ" = (/obj/effect/landmark/portal_exit{id = portalnumero21},/obj/machinery/light/floor{alpha = 0},/turf/open/floor/carpet/red,/area/wizard_station{name = "Wizard's Unholy Maze"})
"bb" = (/obj/effect/portal/permanent/one_way{id = portalnumero16},/turf/open/floor/carpet/red,/area/wizard_station{name = "Wizard's Unholy Maze"})
"bv" = (/obj/effect/portal/permanent/one_way{id = portalnumero1},/turf/open/floor/carpet/red,/area/wizard_station{name = "Wizard's Unholy Maze"})
"bB" = (/obj/effect/landmark/portal_exit{id = portalnumero17},/obj/machinery/light/floor{alpha = 0},/turf/open/floor/carpet/red,/area/wizard_station{name = "Wizard's Unholy Maze"})
"eF" = (/obj/machinery/light/floor{alpha = 0},/turf/open/floor/carpet/purple,/area/wizard_station{name = "Wizard's Unholy Maze"})
"fb" = (/obj/effect/portal/permanent/one_way{id = portalnumero19},/turf/open/floor/carpet/red,/area/wizard_station{name = "Wizard's Unholy Maze"})
"fw" = (/obj/effect/landmark/portal_exit{id = portalnumero18},/obj/machinery/light/floor{alpha = 0},/turf/open/floor/carpet/red,/area/wizard_station{name = "Wizard's Unholy Maze"})
"gr" = (/obj/effect/landmark/portal_exit{id = portalnumero16},/obj/machinery/light/floor{alpha = 0},/turf/open/floor/carpet/red,/area/wizard_station{name = "Wizard's Unholy Maze"})
"hd" = (/obj/effect/portal/permanent/one_way{id = portalnumero21},/turf/open/floor/carpet/red,/area/wizard_station{name = "Wizard's Unholy Maze"})
"hf" = (/obj/effect/portal/permanent/one_way{id = portalnumero17},/turf/open/floor/carpet/red,/area/wizard_station{name = "Wizard's Unholy Maze"})
"hh" = (/obj/effect/landmark/portal_exit{id = portalnumero26},/obj/machinery/light/floor{alpha = 0},/turf/open/floor/carpet/red,/area/wizard_station{name = "Wizard's Unholy Maze"})
"ix" = (/obj/effect/portal/permanent/one_way{id = portalnumero22},/turf/open/floor/carpet/red,/area/wizard_station{name = "Wizard's Unholy Maze"})
"iH" = (/obj/effect/portal/permanent/one_way{id = portalnumero28},/turf/open/floor/carpet/red,/area/wizard_station{name = "Wizard's Unholy Maze"})
"jv" = (/obj/effect/portal/permanent/one_way{id = portalnumero2},/turf/open/floor/carpet/red,/area/wizard_station{name = "Wizard's Unholy Maze"})
"jA" = (/turf/open/floor/carpet/red,/area/wizard_station{name = "Wizard's Unholy Maze"})
"jU" = (/obj/effect/portal/permanent/one_way{id = portalnumero31},/turf/open/floor/carpet/blue,/area/wizard_station{name = "Wizard's Unholy Maze"})
"jX" = (/obj/effect/landmark/portal_exit{id = portalnumero8},/obj/machinery/light/floor{alpha = 0},/turf/open/floor/carpet/red,/area/wizard_station{name = "Wizard's Unholy Maze"})
"mI" = (/obj/effect/landmark/portal_exit{id = portalnumero3},/obj/machinery/light/floor{alpha = 0},/turf/open/floor/carpet/red,/area/wizard_station{name = "Wizard's Unholy Maze"})
"nO" = (/obj/effect/portal/permanent/one_way{id = portalnumero7},/turf/open/floor/carpet/red,/area/wizard_station{name = "Wizard's Unholy Maze"})
"oy" = (/obj/effect/portal/permanent/one_way{id = portalnumero4},/turf/open/floor/carpet/red,/area/wizard_station{name = "Wizard's Unholy Maze"})
"qu" = (/obj/effect/portal/permanent/one_way{id = portalnumero5},/turf/open/floor/carpet/red,/area/wizard_station{name = "Wizard's Unholy Maze"})
"qS" = (/obj/structure/table/wood/fancy/red,/obj/item/clothing/head/wizard/red,/obj/item/clothing/suit/wizrobe/red,/obj/item/clothing/shoes/sandal/magic,/turf/open/floor/carpet/blue,/area/wizard_station{name = "Wizard's Unholy Maze"})
"tq" = (/obj/effect/portal/permanent/one_way{id = portalnumero3},/turf/open/floor/carpet/red,/area/wizard_station{name = "Wizard's Unholy Maze"})
"tK" = (/obj/effect/portal/permanent/one_way{id = portalnumero23},/turf/open/floor/carpet/red,/area/wizard_station{name = "Wizard's Unholy Maze"})
"tV" = (/obj/structure/table/wood/fancy/green,/obj/item/spellbook{desc = "An unearthly tome that glows with power. It's missing a few pages, but you can still understand some of it."; name = "lesser spell book"; uses = 5},/obj/machinery/light/floor{alpha = 0},/turf/open/floor/carpet/blue,/area/wizard_station{name = "Wizard's Unholy Maze"})
"ub" = (/obj/effect/portal/permanent/one_way{id = portalnumero14},/turf/open/floor/carpet/red,/area/wizard_station{name = "Wizard's Unholy Maze"})
"uy" = (/obj/effect/landmark/portal_exit{id = portalnumero0},/turf/open/floor/carpet/purple,/area/wizard_station{name = "Wizard's Unholy Maze"})
"vb" = (/obj/effect/landmark/portal_exit{id = portalnumero13},/obj/machinery/light/floor{alpha = 0},/turf/open/floor/carpet/red,/area/wizard_station{name = "Wizard's Unholy Maze"})
"vk" = (/obj/effect/portal/permanent/one_way{id = portalnumero20},/turf/open/floor/carpet/red,/area/wizard_station{name = "Wizard's Unholy Maze"})
"vs" = (/obj/effect/landmark/portal_exit{id = portalnumero4},/obj/machinery/light/floor{alpha = 0; light_range = 3},/turf/open/floor/carpet/red,/area/wizard_station{name = "Wizard's Unholy Maze"})
"vJ" = (/obj/effect/landmark/portal_exit{id = portalnumero23},/obj/machinery/light/floor{alpha = 0},/turf/open/floor/carpet/red,/area/wizard_station{name = "Wizard's Unholy Maze"})
"vM" = (/obj/effect/portal/permanent/one_way{id = portalnumero15},/turf/open/floor/carpet/red,/area/wizard_station{name = "Wizard's Unholy Maze"})
"vY" = (/obj/effect/portal/permanent/one_way{id = portalnumero8},/turf/open/floor/carpet/red,/area/wizard_station{name = "Wizard's Unholy Maze"})
"wC" = (/obj/effect/portal/permanent/one_way{id = portalnumero29},/turf/open/floor/carpet/red,/area/wizard_station{name = "Wizard's Unholy Maze"})
"wO" = (/turf/closed/indestructible/riveted/uranium{name = "emerald wall"},/area/wizard_station{name = "Wizard's Unholy Maze"})
"yd" = (/obj/effect/landmark/portal_exit{id = portalnumero31},/turf/open/floor/carpet/purple,/area/wizard_station{name = "Wizard's Unholy Maze"})
"yw" = (/obj/effect/landmark/portal_exit{id = portalnumero5},/obj/machinery/light/floor{alpha = 0},/turf/open/floor/carpet/red,/area/wizard_station{name = "Wizard's Unholy Maze"})
"za" = (/obj/structure/table/wood/fancy/green,/obj/item/paper/fluff/ruins{info = "Greetings acolyte! Congratulations on completing thy first reality bending course! Before thou taketh thy garbs and tome, thy shalt be cautious, for reality bending spells such as Event Summoning, have their magic circles corrupted, and will be futile to learn such spells. Congratulations again, and thou shalt prepare for thy next exam!"; name = "A word of caution"},/turf/open/floor/carpet/blue,/area/wizard_station{name = "Wizard's Unholy Maze"})
"zu" = (/obj/effect/landmark/portal_exit{id = portalnumero11},/obj/machinery/light/floor{alpha = 0; light_range = 3},/turf/open/floor/carpet/red,/area/wizard_station{name = "Wizard's Unholy Maze"})
"Ak" = (/obj/effect/landmark/portal_exit{id = portalnumero1},/obj/machinery/light/floor{alpha = 0},/turf/open/floor/carpet/red,/area/wizard_station{name = "Wizard's Unholy Maze"})
"Ap" = (/obj/effect/landmark/portal_exit{id = portalnumero29},/obj/machinery/light/floor{alpha = 0},/turf/open/floor/carpet/red,/area/wizard_station{name = "Wizard's Unholy Maze"})
"AL" = (/obj/effect/landmark/portal_exit{id = portalnumero7},/obj/machinery/light/floor{alpha = 0},/turf/open/floor/carpet/red,/area/wizard_station{name = "Wizard's Unholy Maze"})
"Ck" = (/obj/effect/landmark/portal_exit{id = portalnumero19},/obj/machinery/light/floor{alpha = 0},/turf/open/floor/carpet/red,/area/wizard_station{name = "Wizard's Unholy Maze"})
"Dm" = (/obj/structure/showcase{desc = "A historical figure of great importance to the wizard federation. He spent his long life learning magic, stealing artifacts, and harassing idiots with swords. May he rest forever, Rodney."; icon = 'icons/mob/mob.dmi'; icon_state = "nim"; name = "wizard of yendor showcase"},/turf/open/floor/carpet/blue,/area/wizard_station{name = "Wizard's Unholy Maze"})
"Dr" = (/turf/open/floor/carpet/purple,/area/wizard_station{name = "Wizard's Unholy Maze"})
"DC" = (/obj/effect/landmark/portal_exit{id = portalnumero22},/obj/machinery/light/floor{alpha = 0},/turf/open/floor/carpet/red,/area/wizard_station{name = "Wizard's Unholy Maze"})
"DG" = (/obj/effect/landmark/portal_exit{id = portalnumero25},/obj/machinery/light/floor{alpha = 0},/turf/open/floor/carpet/red,/area/wizard_station{name = "Wizard's Unholy Maze"})
"Ed" = (/obj/structure/table/wood/fancy/royalblue,/obj/item/clothing/head/wizard,/obj/item/clothing/suit/wizrobe,/obj/item/clothing/shoes/sandal/magic,/turf/open/floor/carpet/blue,/area/wizard_station{name = "Wizard's Unholy Maze"})
"Ga" = (/obj/effect/portal/permanent/one_way{id = portalnumero10},/turf/open/floor/carpet/red,/area/wizard_station{name = "Wizard's Unholy Maze"})
"Gy" = (/obj/effect/portal/permanent/one_way{id = portalnumero12},/turf/open/floor/carpet/red,/area/wizard_station{name = "Wizard's Unholy Maze"})
"GE" = (/obj/effect/portal/permanent/one_way{id = portalnumero1},/turf/open/floor/carpet/purple,/area/wizard_station{name = "Wizard's Unholy Maze"})
"GL" = (/obj/machinery/light/floor{alpha = 0},/turf/open/floor/carpet/blue,/area/wizard_station{name = "Wizard's Unholy Maze"})
"HF" = (/obj/effect/portal/permanent/one_way{id = portalnumero30},/turf/open/floor/carpet/red,/area/wizard_station{name = "Wizard's Unholy Maze"})
"HN" = (/obj/effect/landmark/portal_exit{id = portalnumero27},/obj/machinery/light/floor{alpha = 0},/turf/open/floor/carpet/red,/area/wizard_station{name = "Wizard's Unholy Maze"})
"Id" = (/obj/effect/landmark/portal_exit{id = portalnumero10},/obj/machinery/light/floor{alpha = 0},/turf/open/floor/carpet/red,/area/wizard_station{name = "Wizard's Unholy Maze"})
"IF" = (/turf/open/floor/carpet/blue,/area/wizard_station{name = "Wizard's Unholy Maze"})
"IL" = (/obj/effect/portal/permanent/one_way{id = portalnumero11},/turf/open/floor/carpet/red,/area/wizard_station{name = "Wizard's Unholy Maze"})
"KI" = (/obj/effect/portal/permanent/one_way{id = portalnumero13},/turf/open/floor/carpet/red,/area/wizard_station{name = "Wizard's Unholy Maze"})
"LL" = (/obj/effect/portal/permanent/one_way{id = portalnumero27},/turf/open/floor/carpet/red,/area/wizard_station{name = "Wizard's Unholy Maze"})
"Mr" = (/obj/effect/portal/permanent/one_way{id = portalnumero25},/turf/open/floor/carpet/red,/area/wizard_station{name = "Wizard's Unholy Maze"})
"Mu" = (/obj/effect/portal/permanent/one_way{id = portalnumero18},/turf/open/floor/carpet/red,/area/wizard_station{name = "Wizard's Unholy Maze"})
"MP" = (/obj/effect/landmark/portal_exit{id = portalnumero24},/obj/machinery/light/floor{alpha = 0},/turf/open/floor/carpet/red,/area/wizard_station{name = "Wizard's Unholy Maze"})
"MX" = (/obj/effect/landmark/portal_exit{id = portalnumero14},/obj/machinery/light/floor{alpha = 0},/turf/open/floor/carpet/red,/area/wizard_station{name = "Wizard's Unholy Maze"})
"Ne" = (/obj/effect/portal/permanent/one_way{id = portalnumero0},/turf/open/floor/carpet/red,/area/wizard_station{name = "Wizard's Unholy Maze"})
"Nn" = (/obj/effect/portal/permanent/one_way{id = portalnumero9},/turf/open/floor/carpet/red,/area/wizard_station{name = "Wizard's Unholy Maze"})
"Nu" = (/obj/effect/portal/permanent/one_way{id = portalnumero24},/turf/open/floor/carpet/red,/area/wizard_station{name = "Wizard's Unholy Maze"})
"Nz" = (/obj/effect/landmark/portal_exit{id = portalnumero2},/obj/machinery/light/floor{alpha = 0},/turf/open/floor/carpet/red,/area/wizard_station{name = "Wizard's Unholy Maze"})
"ST" = (/obj/effect/portal/permanent/one_way{id = portalnumero6},/turf/open/floor/carpet/red,/area/wizard_station{name = "Wizard's Unholy Maze"})
"TG" = (/obj/effect/landmark/portal_exit{id = portalnumero6},/obj/machinery/light/floor{alpha = 0},/turf/open/floor/carpet/red,/area/wizard_station{name = "Wizard's Unholy Maze"})
"WB" = (/obj/effect/portal/permanent/one_way{id = portalnumero26},/turf/open/floor/carpet/red,/area/wizard_station{name = "Wizard's Unholy Maze"})
"XD" = (/obj/effect/portal/permanent/one_way{id = portalnumero0},/turf/open/floor/carpet/purple,/area/wizard_station{name = "Wizard's Unholy Maze"})
"XJ" = (/obj/effect/landmark/portal_exit{id = portalnumero30},/turf/open/floor/carpet/blue,/area/wizard_station{name = "Wizard's Unholy Maze"})
"XP" = (/obj/effect/landmark/portal_exit{id = portalnumero28},/obj/machinery/light/floor{alpha = 0},/turf/open/floor/carpet/red,/area/wizard_station{name = "Wizard's Unholy Maze"})
"Yx" = (/obj/effect/landmark/portal_exit{id = portalnumero20},/obj/machinery/light/floor{alpha = 0},/turf/open/floor/carpet/red,/area/wizard_station{name = "Wizard's Unholy Maze"})
"ZE" = (/obj/effect/landmark/portal_exit{id = portalnumero15},/obj/machinery/light/floor{alpha = 0},/turf/open/floor/carpet/red,/area/wizard_station{name = "Wizard's Unholy Maze"})
"ZQ" = (/turf/open/space/basic,/area/space)

(1,1,1) = {"
ZQZQZQZQZQZQZQZQZQZQZQZQZQZQZQZQZQZQZQZQZQZQZQZQZQZQZQZQZQZQZQZQZQZQZQZQZQZQZQZQZQZQZQZQZQZQZQZQZQZQZQZQZQZQZQZQZQZQZQZQZQZQZQZQ
ZQZQZQZQZQZQZQZQZQZQZQZQZQZQZQZQZQZQZQZQZQZQZQZQZQZQZQZQZQZQZQydZQZQZQZQZQZQZQZQZQZQZQZQZQZQZQZQZQZQZQZQZQZQZQZQZQZQZQZQZQZQZQZQ
ZQZQZQZQZQZQZQZQZQZQZQZQZQZQZQZQZQZQZQZQZQZQZQZQZQZQZQZQwOwOwOwOwOwOwOZQZQZQZQZQZQZQZQZQZQZQZQZQZQZQZQZQZQZQZQZQZQZQZQZQZQZQZQZQ
ZQZQZQZQZQZQZQZQZQZQZQZQZQZQZQZQZQZQZQZQZQZQZQZQZQwOwOwOwOwOwOwOwOwOwOwOwOwOZQZQZQZQZQZQZQZQZQZQZQZQZQZQZQZQZQZQZQZQZQZQZQZQZQZQ
ZQZQZQZQZQZQZQZQZQZQZQZQZQZQZQZQZQZQZQZQZQZQZQwOwOwOwOwOLLjAwCwOiHjAiHwOwOwOwOwOZQZQZQZQZQZQZQZQZQZQZQZQZQZQZQZQZQZQZQZQZQZQZQZQ
ZQZQZQZQZQZQZQZQZQZQZQZQZQZQZQZQZQZQZQZQZQZQwOwOwOwOwOwOjAXPjAwOjAApjAwOwOwOwOwOwOZQZQZQZQZQZQZQZQZQZQZQZQZQZQZQZQZQZQZQZQZQZQZQ
ZQZQZQZQZQZQZQZQZQZQZQZQZQZQZQZQZQZQZQZQZQwOwOwOwOwOwOwOLLjALLwOHFjAiHwOwOwOwOwOwOwOZQZQZQZQZQZQZQZQZQZQZQZQZQZQZQZQZQZQZQZQZQZQ
ZQZQZQZQZQZQZQZQZQZQZQZQZQZQZQZQZQZQZQZQwOwOwOwOMrjAtKwOwOwOwOwOwOwOwOwOWBjAWBwOwOwOwOZQZQZQZQZQZQZQZQZQZQZQZQZQZQZQZQZQZQZQZQZQ
ZQZQZQZQZQZQZQZQZQZQZQZQZQZQZQZQZQZQZQwOwOwOwOwOjAMPjAwOWBjANuwOMrjAMrwOjAHNjAwOwOwOwOwOZQZQZQZQZQZQZQZQZQZQZQZQZQZQZQZQZQZQZQZQ
ZQZQZQZQZQZQZQZQZQZQZQZQZQZQZQZQZQZQwOwOwOwOwOwOtKjAtKwOjADGjAwOjAhhjAwOiHjAWBwOwOwOwOwOwOZQZQZQZQZQZQZQZQZQZQZQZQZQZQZQZQZQZQZQ
ZQZQZQZQZQZQZQZQZQZQZQZQZQZQZQZQZQZQwOwOwOwOwOwOwOwOwOwONujANuwOMrjALLwOwOwOwOwOwOwOwOwOwOZQZQZQZQZQZQZQZQZQZQZQZQZQZQZQZQZQZQZQ
ZQZQZQZQZQZQZQZQZQZQZQZQZQZQZQZQZQwOwOwOfbjAfbwOixjAvkwOwOwOwOwOwOwOwOwOhdjAhdwONujAixwOwOwOZQZQZQZQZQZQZQZQZQZQZQZQZQZQZQZQZQZQ
ZQZQZQZQZQZQZQZQZQZQZQZQZQZQZQZQZQwOwOwOjAYxjAwOjAaZjAwODmIFIFjUIFIFDmwOjADCjAwOjAvJjAwOwOwOZQZQZQZQZQZQZQZQZQZQZQZQZQZQZQZQZQZQ
ZQZQZQZQZQZQZQZQZQZQZQZQZQZQZQZQZQwOwOwOhdjAfbwOvkjAvkwOIFGLIFIFIFGLIFwOhdjAtKwOixjAixwOwOwOZQZQZQZQZQZQZQZQZQZQZQZQZQZQZQZQZQZQ
ZQZQZQZQZQZQZQZQZQZQZQZQZQZQZQZQwOwOwOwOwOwOwOwOwOwOwOwOIFIFIFIFIFIFIFwOwOwOwOwOwOwOwOwOwOwOwOZQZQZQZQZQZQZQZQZQZQZQZQZQZQZQZQZQ
ZQZQZQZQZQZQZQZQZQZQZQZQZQZQZQZQwOwOwOwOvMjAhfwObbjAbbwOIFIFzatVzaIFIFwOfbjAhfwOMujAvkwOwOwOwOZQZQZQZQZQZQZQZQZQZQZQZQZQZQZQZQZQ
ZQZQZQZQZQZQZQZQZQZQZQZQZQZQZQZQwOwOwOwOjAgrjAwOjAbBjAwOIFIFIFIFIFIFIFwOjAfwjAwOjACkjAwOwOwOwOZQZQZQZQZQZQZQZQZQZQZQZQZQZQZQZQZQ
ZQZQZQZQZQZQZQZQZQZQZQZQZQZQZQXDwOwOwOwOvMjAvMwOMujAbbwOIFGLIFIFIFGLIFwOhfjAhfwOMujAMuwOwOwOwOXDZQZQZQZQZQZQZQZQZQZQZQZQZQZQZQZQ
ZQZQZQZQZQZQZQZQZQZQZQZQZQZQZQZQwOwOwOwOwOwOwOwOwOwOwOwOEdIFIFXJIFIFqSwOwOwOwOwOwOwOwOwOwOwOwOZQZQZQZQZQZQZQZQZQZQZQZQZQZQZQZQZQ
ZQZQZQZQZQZQZQZQZQZQZQZQZQZQZQZQwOwOwOwONnjAILwOGajAGawOwOwOwOwOwOwOwOwOKIjAKIwOubjAubwOwOwOwOZQZQZQZQZQZQZQZQZQZQZQZQZQZQZQZQZQ
ZQZQZQZQZQZQZQZQZQZQZQZQZQZQZQZQwOwOwOwOjAIdjAwOjAzujAwOKIjAILwOubjAGywOjAMXjAwOjAZEjAwOwOwOwOZQZQZQZQZQZQZQZQZQZQZQZQZQZQZQZQZQ
ZQZQZQZQZQZQZQZQZQZQZQZQZQZQZQZQZQwOwOwONnjANnwOGyjAGawOjAaVjAwOjAvbjAwOKIjAvMwOubjAbbwOwOwOZQZQZQZQZQZQZQZQZQZQZQZQZQZQZQZQZQZQ
ZQZQZQZQZQZQZQZQZQZQZQZQZQZQZQZQZQwOwOwOwOwOwOwOwOwOwOwOILjAILwOGyjAGywOwOwOwOwOwOwOwOwOwOwOZQZQZQZQZQZQZQZQZQZQZQZQZQZQZQZQZQZQ
ZQZQZQZQZQZQZQZQZQZQZQZQZQZQZQZQZQwOwOwOqujAtqwOoyjAoywOwOwOwOwOwOwOwOwOnOjANnwOvYjAvYwOwOwOZQZQZQZQZQZQZQZQZQZQZQZQZQZQZQZQZQZQ
ZQZQZQZQZQZQZQZQZQZQZQZQZQZQZQZQZQZQwOwOjAvsjAwOjAywjAwOqujAquwOvYjASTwOjAjXjAwOjAaIjAwOwOZQZQZQZQZQZQZQZQZQZQZQZQZQZQZQZQZQZQZQ
ZQZQZQZQZQZQZQZQZQZQZQZQZQZQZQZQZQZQwOwOtqjAtqwOoyjASTwOjATGjAwOjAALjAwOnOjAnOwOvYjAGawOwOZQZQZQZQZQZQZQZQZQZQZQZQZQZQZQZQZQZQZQ
ZQZQZQZQZQZQZQZQZQZQZQZQZQZQZQZQZQZQZQwOwOwOwOwOwOwOwOwOqujAnOwOSTjASTwOwOwOwOwOwOwOwOwOZQZQZQZQZQZQZQZQZQZQZQZQZQZQZQZQZQZQZQZQ
ZQZQZQZQZQZQZQZQZQZQZQZQZQZQZQZQZQZQZQZQwOwOwOwOjvjAjvwOwOwOwOwOwOwOwOwObvjAtqwOwOwOwOZQZQZQZQZQZQZQZQZQZQZQZQZQZQZQZQZQZQZQZQZQ
ZQZQZQZQZQZQZQZQZQZQZQZQZQZQZQZQZQZQZQZQZQwOwOwOjAmIjAwODrGEDrwONejAjvwOjANzjAwOwOwOZQZQZQZQZQZQZQZQZQZQZQZQZQZQZQZQZQZQZQZQZQZQ
ZQZQZQZQZQZQZQZQZQZQZQZQZQZQZQZQZQZQZQZQZQZQwOwOoyjAjvwODreFDrwOjAAkjAwObvjAbvwOwOZQZQZQZQZQZQZQZQZQZQZQZQZQZQZQZQZQZQZQZQZQZQZQ
ZQZQZQZQZQZQZQZQZQZQZQZQZQZQZQZQZQZQZQZQZQZQZQwOwOwOwOwODruyDrwONejANewOwOwOwOwOZQZQZQZQZQZQZQZQZQZQZQZQZQZQZQZQZQZQZQZQZQZQZQZQ
ZQZQZQZQZQZQZQZQZQZQZQZQZQZQZQZQZQZQZQZQZQZQZQZQZQwOwOwOwOwOwOwOwOwOwOwOwOwOZQZQZQZQZQZQZQZQZQZQZQZQZQZQZQZQZQZQZQZQZQZQZQZQZQZQ
ZQZQZQZQZQZQZQZQZQZQZQZQZQZQZQZQZQZQZQZQZQZQZQZQZQZQZQZQwOwOwOwOwOwOwOZQZQZQZQZQZQZQZQZQZQZQZQZQZQZQZQZQZQZQZQZQZQZQZQZQZQZQZQZQ
ZQZQZQZQZQZQZQZQZQZQZQZQZQZQZQZQZQZQZQZQZQZQZQZQZQZQZQZQZQZQZQXDZQZQZQZQZQZQZQZQZQZQZQZQZQZQZQZQZQZQZQZQZQZQZQZQZQZQZQZQZQZQZQZQ
ZQZQZQZQZQZQZQZQZQZQZQZQZQZQZQZQZQZQZQZQZQZQZQZQZQZQZQZQZQZQZQZQZQZQZQZQZQZQZQZQZQZQZQZQZQZQZQZQZQZQZQZQZQZQZQZQZQZQZQZQZQZQZQZQ
ZQZQZQZQZQZQZQZQZQZQZQZQZQZQZQZQZQZQZQZQZQZQZQZQZQZQZQZQZQZQZQZQZQZQZQZQZQZQZQZQZQZQZQZQZQZQZQZQZQZQZQZQZQZQZQZQZQZQZQZQZQZQZQZQ
ZQZQZQZQZQZQZQZQZQZQZQZQZQZQZQZQZQZQZQZQZQZQZQZQZQZQZQZQZQZQZQZQZQZQZQZQZQZQZQZQZQZQZQZQZQZQZQZQZQZQZQZQZQZQZQZQZQZQZQZQZQZQZQZQ
ZQZQZQZQZQZQZQZQZQZQZQZQZQZQZQZQZQZQZQZQZQZQZQZQZQZQZQZQZQZQZQZQZQZQZQZQZQZQZQZQZQZQZQZQZQZQZQZQZQZQZQZQZQZQZQZQZQZQZQZQZQZQZQZQ
ZQZQZQZQZQZQZQZQZQZQZQZQZQZQZQZQZQZQZQZQZQZQZQZQZQZQZQZQZQZQZQZQZQZQZQZQZQZQZQZQZQZQZQZQZQZQZQZQZQZQZQZQZQZQZQZQZQZQZQZQZQZQZQZQ
ZQZQZQZQZQZQZQZQZQZQZQZQZQZQZQZQZQZQZQZQZQZQZQZQZQZQZQZQZQZQZQZQZQZQZQZQZQZQZQZQZQZQZQZQZQZQZQZQZQZQZQZQZQZQZQZQZQZQZQZQZQZQZQZQ
ZQZQZQZQZQZQZQZQZQZQZQZQZQZQZQZQZQZQZQZQZQZQZQZQZQZQZQZQZQZQZQZQZQZQZQZQZQZQZQZQZQZQZQZQZQZQZQZQZQZQZQZQZQZQZQZQZQZQZQZQZQZQZQZQ
ZQZQZQZQZQZQZQZQZQZQZQZQZQZQZQZQZQZQZQZQZQZQZQZQZQZQZQZQZQZQZQZQZQZQZQZQZQZQZQZQZQZQZQZQZQZQZQZQZQZQZQZQZQZQZQZQZQZQZQZQZQZQZQZQ
ZQZQZQZQZQZQZQZQZQZQZQZQZQZQZQZQZQZQZQZQZQZQZQZQZQZQZQZQZQZQZQZQZQZQZQZQZQZQZQZQZQZQZQZQZQZQZQZQZQZQZQZQZQZQZQZQZQZQZQZQZQZQZQZQ
ZQZQZQZQZQZQZQZQZQZQZQZQZQZQZQZQZQZQZQZQZQZQZQZQZQZQZQZQZQZQZQZQZQZQZQZQZQZQZQZQZQZQZQZQZQZQZQZQZQZQZQZQZQZQZQZQZQZQZQZQZQZQZQZQ
ZQZQZQZQZQZQZQZQZQZQZQZQZQZQZQZQZQZQZQZQZQZQZQZQZQZQZQZQZQZQZQZQZQZQZQZQZQZQZQZQZQZQZQZQZQZQZQZQZQZQZQZQZQZQZQZQZQZQZQZQZQZQZQZQ
ZQZQZQZQZQZQZQZQZQZQZQZQZQZQZQZQZQZQZQZQZQZQZQZQZQZQZQZQZQZQZQZQZQZQZQZQZQZQZQZQZQZQZQZQZQZQZQZQZQZQZQZQZQZQZQZQZQZQZQZQZQZQZQZQ
ZQZQZQZQZQZQZQZQZQZQZQZQZQZQZQZQZQZQZQZQZQZQZQZQZQZQZQZQZQZQZQZQZQZQZQZQZQZQZQZQZQZQZQZQZQZQZQZQZQZQZQZQZQZQZQZQZQZQZQZQZQZQZQZQ
ZQZQZQZQZQZQZQZQZQZQZQZQZQZQZQZQZQZQZQZQZQZQZQZQZQZQZQZQZQZQZQZQZQZQZQZQZQZQZQZQZQZQZQZQZQZQZQZQZQZQZQZQZQZQZQZQZQZQZQZQZQZQZQZQ
ZQZQZQZQZQZQZQZQZQZQZQZQZQZQZQZQZQZQZQZQZQZQZQZQZQZQZQZQZQZQZQZQZQZQZQZQZQZQZQZQZQZQZQZQZQZQZQZQZQZQZQZQZQZQZQZQZQZQZQZQZQZQZQZQ
ZQZQZQZQZQZQZQZQZQZQZQZQZQZQZQZQZQZQZQZQZQZQZQZQZQZQZQZQZQZQZQZQZQZQZQZQZQZQZQZQZQZQZQZQZQZQZQZQZQZQZQZQZQZQZQZQZQZQZQZQZQZQZQZQ
ZQZQZQZQZQZQZQZQZQZQZQZQZQZQZQZQZQZQZQZQZQZQZQZQZQZQZQZQZQZQZQZQZQZQZQZQZQZQZQZQZQZQZQZQZQZQZQZQZQZQZQZQZQZQZQZQZQZQZQZQZQZQZQZQ
ZQZQZQZQZQZQZQZQZQZQZQZQZQZQZQZQZQZQZQZQZQZQZQZQZQZQZQZQZQZQZQZQZQZQZQZQZQZQZQZQZQZQZQZQZQZQZQZQZQZQZQZQZQZQZQZQZQZQZQZQZQZQZQZQ
ZQZQZQZQZQZQZQZQZQZQZQZQZQZQZQZQZQZQZQZQZQZQZQZQZQZQZQZQZQZQZQZQZQZQZQZQZQZQZQZQZQZQZQZQZQZQZQZQZQZQZQZQZQZQZQZQZQZQZQZQZQZQZQZQ
ZQZQZQZQZQZQZQZQZQZQZQZQZQZQZQZQZQZQZQZQZQZQZQZQZQZQZQZQZQZQZQZQZQZQZQZQZQZQZQZQZQZQZQZQZQZQZQZQZQZQZQZQZQZQZQZQZQZQZQZQZQZQZQZQ
ZQZQZQZQZQZQZQZQZQZQZQZQZQZQZQZQZQZQZQZQZQZQZQZQZQZQZQZQZQZQZQZQZQZQZQZQZQZQZQZQZQZQZQZQZQZQZQZQZQZQZQZQZQZQZQZQZQZQZQZQZQZQZQZQ
ZQZQZQZQZQZQZQZQZQZQZQZQZQZQZQZQZQZQZQZQZQZQZQZQZQZQZQZQZQZQZQZQZQZQZQZQZQZQZQZQZQZQZQZQZQZQZQZQZQZQZQZQZQZQZQZQZQZQZQZQZQZQZQZQ
ZQZQZQZQZQZQZQZQZQZQZQZQZQZQZQZQZQZQZQZQZQZQZQZQZQZQZQZQZQZQZQZQZQZQZQZQZQZQZQZQZQZQZQZQZQZQZQZQZQZQZQZQZQZQZQZQZQZQZQZQZQZQZQZQ
ZQZQZQZQZQZQZQZQZQZQZQZQZQZQZQZQZQZQZQZQZQZQZQZQZQZQZQZQZQZQZQZQZQZQZQZQZQZQZQZQZQZQZQZQZQZQZQZQZQZQZQZQZQZQZQZQZQZQZQZQZQZQZQZQ
ZQZQZQZQZQZQZQZQZQZQZQZQZQZQZQZQZQZQZQZQZQZQZQZQZQZQZQZQZQZQZQZQZQZQZQZQZQZQZQZQZQZQZQZQZQZQZQZQZQZQZQZQZQZQZQZQZQZQZQZQZQZQZQZQ
ZQZQZQZQZQZQZQZQZQZQZQZQZQZQZQZQZQZQZQZQZQZQZQZQZQZQZQZQZQZQZQZQZQZQZQZQZQZQZQZQZQZQZQZQZQZQZQZQZQZQZQZQZQZQZQZQZQZQZQZQZQZQZQZQ
ZQZQZQZQZQZQZQZQZQZQZQZQZQZQZQZQZQZQZQZQZQZQZQZQZQZQZQZQZQZQZQZQZQZQZQZQZQZQZQZQZQZQZQZQZQZQZQZQZQZQZQZQZQZQZQZQZQZQZQZQZQZQZQZQ
ZQZQZQZQZQZQZQZQZQZQZQZQZQZQZQZQZQZQZQZQZQZQZQZQZQZQZQZQZQZQZQZQZQZQZQZQZQZQZQZQZQZQZQZQZQZQZQZQZQZQZQZQZQZQZQZQZQZQZQZQZQZQZQZQ
ZQZQZQZQZQZQZQZQZQZQZQZQZQZQZQZQZQZQZQZQZQZQZQZQZQZQZQZQZQZQZQZQZQZQZQZQZQZQZQZQZQZQZQZQZQZQZQZQZQZQZQZQZQZQZQZQZQZQZQZQZQZQZQZQ
ZQZQZQZQZQZQZQZQZQZQZQZQZQZQZQZQZQZQZQZQZQZQZQZQZQZQZQZQZQZQZQZQZQZQZQZQZQZQZQZQZQZQZQZQZQZQZQZQZQZQZQZQZQZQZQZQZQZQZQZQZQZQZQZQ
"}
