"al" = (/obj/machinery/cryopod,/obj/structure/curtain,/turf/open/floor/pod/dark,/area/ship/crew)
"az" = (/obj/machinery/power/apc/syndicate{dir = 8; name = "Syndicate Drop Ship APC"; pixel_x = -25},/obj/machinery/light/small{dir = 1},/obj/structure/cable/yellow{icon_state = "0-2"},/obj/machinery/atmospherics/components/unary/portables_connector{dir = 4},/obj/machinery/portable_atmospherics/canister/toxins,/obj/effect/turf_decal/industrial/hatch/yellow{dir = 4},/turf/open/floor/pod/dark,/area/ship/crew)
"bo" = (/obj/machinery/firealarm{dir = 8; pixel_x = -24},/turf/open/floor/plasteel/dark,/area/ship/crew)
"bB" = (/obj/machinery/light/small{dir = 8},/obj/machinery/button/door{id = "caravansyndicate3_bolt_starboard"; name = "External Bolt Control"; normaldoorcontrol = 1; pixel_x = -24; pixel_y = -6; req_access_txt = "150"; specialfunctions = 4},/turf/open/floor/plasteel/dark,/area/ship/crew)
"bN" = (/obj/machinery/power/smes{charge = 5e+006},/obj/effect/turf_decal/industrial/warning{dir = 5},/obj/effect/decal/cleanable/dirt,/obj/effect/decal/cleanable/dirt,/obj/machinery/atmospherics/pipe/simple/orange/hidden{dir = 10},/obj/structure/cable/yellow,/turf/open/floor/plating,/area/ship/crew)
"cB" = (/obj/effect/turf_decal/corner/neutral{dir = 1},/obj/effect/turf_decal/corner/neutral,/obj/effect/turf_decal/corner/neutral{dir = 4},/obj/effect/turf_decal/corner/neutral{dir = 8},/turf/open/floor/plasteel/dark,/area/ship/crew)
"dZ" = (/obj/machinery/power/shuttle/engine/fueled/plasma{dir = 4},/turf/open/floor/plating/airless,/area/ship/crew)
"gl" = (/obj/machinery/door/airlock/hatch{id_tag = "caravansyndicate3_bolt_port"; name = "External Airlock"; normalspeed = 0; req_access_txt = "150"},/obj/docking_port/mobile{dir = 2; dwidth = 6; height = 7; name = "Syndicate Drop Ship"; port_direction = 8; preferred_direction = 4; width = 15},/obj/structure/fans/tiny,/turf/open/floor/mineral/plastitanium,/area/ship/crew)
"ha" = (/obj/machinery/power/port_gen/pacman{anchored = 1},/obj/item/wrench,/obj/effect/decal/cleanable/dirt,/obj/structure/cable,/obj/effect/turf_decal/industrial/warning{dir = 6},/obj/machinery/atmospherics/pipe/simple/orange/hidden{dir = 9},/turf/open/floor/plating,/area/ship/crew)
"ka" = (/obj/machinery/atmospherics/pipe/simple/orange/hidden{dir = 4},/obj/machinery/suit_storage_unit/syndicate,/turf/open/floor/pod/dark,/area/ship/crew)
"mG" = (/obj/machinery/computer/cryopod,/turf/closed/wall/mineral/plastitanium/nodiagonal,/area/ship/crew)
"ns" = (/obj/effect/turf_decal/corner/red,/obj/effect/turf_decal/corner/red{dir = 4},/obj/effect/turf_decal/corner/red{dir = 8},/obj/machinery/suit_storage_unit/syndicate{name = "captain's suit storage unit"; storage_type = /obj/item/clothing/shoes/magboots/syndie; suit_type = /obj/item/clothing/suit/space/hardsuit/syndi/elite},/turf/open/floor/plasteel/dark,/area/ship/crew)
"qE" = (/obj/effect/turf_decal/industrial/warning{dir = 9},/obj/machinery/stasis,/turf/open/floor/mineral/plastitanium,/area/ship/crew)
"rz" = (/obj/effect/turf_decal/corner/red{dir = 1},/obj/effect/turf_decal/corner/red{dir = 8},/obj/machinery/computer/helm{dir = 8},/turf/open/floor/plasteel/dark,/area/ship/crew)
"rU" = (/obj/structure/grille,/obj/structure/window/plasma/reinforced/plastitanium,/obj/machinery/door/poddoor{id = "caravansyndicate3_bridge"},/turf/open/floor/plating,/area/ship/crew)
"rV" = (/obj/machinery/suit_storage_unit/syndicate,/turf/open/floor/pod/dark,/area/ship/crew)
"sb" = (/obj/effect/turf_decal/corner/red{dir = 1},/obj/effect/turf_decal/corner/red,/obj/effect/turf_decal/corner/red{dir = 8},/obj/machinery/photocopier/faxmachine/longrange,/obj/structure/table/reinforced,/turf/open/floor/plasteel/dark,/area/ship/crew)
"sn" = (/obj/machinery/atmospherics/pipe/simple/orange/hidden{dir = 4},/obj/structure/chair/comfy/shuttle,/turf/open/floor/pod/dark,/area/ship/crew)
"ss" = (/obj/effect/turf_decal/corner/red{dir = 1},/obj/effect/turf_decal/corner/red{dir = 4},/turf/open/floor/plasteel/dark,/area/ship/crew)
"uy" = (/obj/structure/table/reinforced,/obj/machinery/light/small{dir = 8},/obj/effect/turf_decal/corner/red{dir = 1},/obj/effect/turf_decal/corner/red,/obj/effect/turf_decal/corner/red{dir = 8},/obj/item/gun/ballistic/revolver,/obj/item/ammo_box/a357,/obj/item/ammo_box/a357,/obj/item/ammo_box/a357,/obj/item/card/emag,/turf/open/floor/plasteel/dark,/area/ship/crew)
"vw" = (/obj/structure/table/reinforced,/obj/item/assembly/flash/handheld,/obj/effect/turf_decal/corner/red{dir = 1},/obj/effect/turf_decal/corner/red,/obj/effect/turf_decal/corner/red{dir = 4},/obj/item/clothing/head/HoS/beret/syndicate,/obj/item/clothing/glasses/thermal/syndi,/turf/open/floor/plasteel/dark,/area/ship/crew)
"wH" = (/obj/structure/window/reinforced{dir = 4},/obj/machinery/atmospherics/components/unary/shuttle/heater{dir = 4},/turf/open/floor/plating/airless,/area/ship/crew)
"xC" = (/obj/machinery/light/small{dir = 8},/obj/machinery/button/door{id = "caravansyndicate3_bolt_port"; name = "External Bolt Control"; normaldoorcontrol = 1; pixel_x = -24; pixel_y = 6; req_access_txt = "150"; specialfunctions = 4},/turf/open/floor/plasteel/dark,/area/ship/crew)
"Bp" = (/obj/effect/turf_decal/corner/red,/obj/effect/turf_decal/corner/red{dir = 8},/obj/machinery/atmospherics/pipe/simple/orange/hidden,/turf/open/floor/plasteel/dark,/area/ship/crew)
"BQ" = (/obj/effect/turf_decal/corner/red,/obj/effect/turf_decal/corner/red{dir = 8},/turf/open/floor/plasteel/dark,/area/ship/crew)
"Cm" = (/obj/machinery/firealarm{dir = 1; pixel_y = -26},/obj/machinery/atmospherics/pipe/simple/orange/hidden{dir = 9},/obj/machinery/suit_storage_unit/syndicate,/turf/open/floor/pod/dark,/area/ship/crew)
"Dt" = (/obj/effect/turf_decal/industrial/warning{dir = 8},/obj/machinery/light/small,/obj/structure/table/reinforced,/obj/item/storage/backpack/duffelbag/syndie/surgery,/turf/open/floor/mineral/plastitanium,/area/ship/crew)
"Dx" = (/obj/effect/decal/cleanable/dirt,/obj/effect/turf_decal/corner/neutral{dir = 1},/obj/effect/turf_decal/corner/neutral,/obj/effect/turf_decal/corner/neutral{dir = 4},/obj/effect/turf_decal/corner/neutral{dir = 8},/turf/open/floor/plasteel/dark,/area/ship/crew)
"EO" = (/obj/machinery/airalarm/syndicate{pixel_y = 24},/obj/machinery/atmospherics/pipe/simple/orange/hidden{dir = 10},/obj/structure/chair/comfy/shuttle,/turf/open/floor/pod/dark,/area/ship/crew)
"Fa" = (/obj/effect/turf_decal/industrial/warning{dir = 10},/obj/structure/rack,/obj/item/melee/transforming/energy/sword/saber/red,/obj/item/melee/transforming/energy/sword/saber/red,/obj/item/melee/transforming/energy/sword/saber/red,/obj/item/gun/ballistic/automatic/pistol/APS,/obj/item/gun/ballistic/automatic/pistol/APS,/obj/item/gun/ballistic/automatic/pistol/APS,/obj/item/ammo_box/magazine/pistolm9mm,/obj/item/ammo_box/magazine/pistolm9mm,/obj/item/ammo_box/magazine/pistolm9mm,/obj/item/ammo_box/magazine/pistolm9mm,/obj/item/ammo_box/magazine/pistolm9mm,/obj/item/ammo_box/magazine/pistolm9mm,/obj/item/ammo_box/magazine/pistolm9mm,/obj/item/ammo_box/magazine/pistolm9mm,/obj/item/ammo_box/magazine/pistolm9mm,/turf/open/floor/mineral/plastitanium,/area/ship/crew)
"Gx" = (/obj/machinery/airalarm/syndicate{dir = 4; pixel_x = -24},/turf/open/floor/plasteel/dark,/area/ship/crew)
"HJ" = (/obj/effect/turf_decal/industrial/warning{dir = 8},/obj/structure/sign/warning/vacuum{pixel_y = -32},/obj/machinery/mineral/ore_redemption{dir = 8},/turf/open/floor/mineral/plastitanium,/area/ship/crew)
"HM" = (/obj/structure/chair/comfy/shuttle{dir = 4},/turf/open/floor/plasteel/dark,/area/ship/crew)
"Ij" = (/obj/effect/turf_decal/corner/red{dir = 4},/turf/open/floor/plasteel/dark,/area/ship/crew)
"IU" = (/obj/effect/turf_decal/corner/neutral{dir = 1},/obj/effect/turf_decal/corner/neutral,/obj/effect/turf_decal/corner/neutral{dir = 4},/obj/effect/turf_decal/corner/neutral{dir = 8},/obj/machinery/atmospherics/pipe/simple/orange/hidden{dir = 10},/turf/open/floor/plasteel/dark,/area/ship/crew)
"Jv" = (/turf/template_noop,/area/template_noop)
"KS" = (/obj/machinery/door/airlock/hatch{id_tag = "caravansyndicate3_bolt_starboard"; name = "External Airlock"; normalspeed = 0; req_access_txt = "150"},/obj/structure/fans/tiny,/turf/open/floor/mineral/plastitanium,/area/ship/crew)
"Lq" = (/obj/effect/turf_decal/industrial/warning{dir = 8},/obj/structure/sign/warning/vacuum{pixel_y = 32},/obj/machinery/autolathe/hacked,/turf/open/floor/mineral/plastitanium,/area/ship/crew)
"NH" = (/obj/effect/turf_decal/industrial/warning{dir = 8},/obj/machinery/light/small{dir = 1},/obj/machinery/vending/security/marine,/turf/open/floor/mineral/plastitanium,/area/ship/crew)
"Pt" = (/obj/effect/turf_decal/industrial/warning{dir = 4},/obj/structure/closet/crate,/obj/machinery/power/terminal{dir = 1},/obj/item/stack/sheet/metal/twenty,/obj/item/stack/sheet/glass{amount = 10},/obj/item/stack/sheet/mineral/plastitanium{amount = 20},/obj/item/storage/box/lights/bulbs,/obj/item/storage/toolbox/mechanical,/obj/item/stack/sheet/mineral/plasma{amount = 20},/obj/structure/cable{icon_state = "0-2"},/obj/machinery/atmospherics/pipe/manifold4w/orange/hidden,/turf/open/floor/plating,/area/ship/crew)
"PL" = (/obj/effect/turf_decal/corner/red{dir = 1},/obj/effect/turf_decal/corner/red{dir = 4},/obj/machinery/atmospherics/pipe/simple/orange/hidden,/turf/open/floor/plasteel/dark,/area/ship/crew)
"PY" = (/obj/machinery/atmospherics/components/unary/tank/toxins{dir = 1},/obj/effect/turf_decal/industrial/hatch/yellow{dir = 4},/obj/machinery/light/small,/turf/open/floor/pod/dark,/area/ship/crew)
"Sl" = (/obj/structure/table/reinforced,/obj/machinery/light/small{dir = 8},/obj/effect/turf_decal/corner/red{dir = 1},/obj/effect/turf_decal/corner/red{dir = 4},/obj/effect/turf_decal/corner/red{dir = 8},/obj/item/soap/syndie,/obj/item/defibrillator/compact/combat,/obj/item/storage/firstaid/tactical,/turf/open/floor/plasteel/dark,/area/ship/crew)
"Tn" = (/turf/closed/wall/mineral/plastitanium/nodiagonal,/area/ship/crew)
"Vf" = (/obj/effect/turf_decal/corner/neutral{dir = 1},/obj/effect/turf_decal/corner/neutral,/obj/effect/turf_decal/corner/neutral{dir = 4},/obj/effect/turf_decal/corner/neutral{dir = 8},/obj/machinery/door/airlock/hatch{id_tag = "caravansyndicate3_bolt_port"; name = "External Airlock"; normalspeed = 0; req_access_txt = "150"},/turf/open/floor/plasteel/dark,/area/ship/crew)
"Wr" = (/obj/effect/turf_decal/corner/red,/turf/open/floor/plasteel/dark,/area/ship/crew)
"YU" = (/obj/effect/turf_decal/industrial/warning{dir = 10},/obj/structure/closet/syndicate{anchored = 1},/obj/item/clothing/under/syndicate/combat,/obj/item/clothing/under/syndicate/combat,/obj/item/clothing/under/syndicate/combat,/obj/item/storage/belt/military,/obj/item/storage/belt/military,/obj/item/storage/belt/military,/obj/item/crowbar/red,/obj/item/crowbar/red,/obj/item/crowbar/red,/obj/item/clothing/glasses/night,/obj/item/clothing/glasses/night,/obj/item/clothing/glasses/night,/obj/item/clothing/mask/gas/syndicate,/obj/item/clothing/mask/gas/syndicate,/obj/item/clothing/mask/gas/syndicate,/turf/open/floor/mineral/plastitanium,/area/ship/crew)
"ZB" = (/turf/closed/wall/mineral/plastitanium,/area/ship/crew)
"ZI" = (/obj/effect/turf_decal/industrial/warning{dir = 9},/obj/structure/ore_box,/obj/item/storage/bag/ore,/obj/item/pickaxe/drill/jackhammer/brigador,/turf/open/floor/mineral/plastitanium,/area/ship/crew)
"ZJ" = (/obj/machinery/atmospherics/components/binary/pump{dir = 8; name = "fuel pump"},/turf/open/floor/plasteel/dark,/area/ship/crew)
"ZK" = (/obj/effect/turf_decal/corner/red{dir = 1},/obj/effect/turf_decal/corner/red{dir = 4},/obj/effect/turf_decal/corner/red{dir = 8},/obj/machinery/computer/autopilot{dir = 8},/turf/open/floor/plasteel/dark,/area/ship/crew)
"ZZ" = (/obj/machinery/firealarm{dir = 8; pixel_x = -24},/obj/machinery/holopad/emergency/command,/turf/open/floor/plasteel/dark,/area/ship/crew)

(1,1,1) = {"
ZBTnTnTnTnmGTnTnglTnTnTnrUrUJv
JvTnazsnEOalNHTnxCLqTnuynsrUrU
dZwHbNssPLssFaTnGxYUTnGxIjsbrU
dZwHPtZJIUcBcBVfcBDxVfcBHMrzrU
dZwHhaBQBpBQqETnboZITnZZWrZKrU
JvTnPYkaCmrVDtTnbBHJTnSlvwrUrU
ZBTnTnTnTnTnTnTnKSTnTnTnrUrUJv
"}
