//MAP CONVERTED BY dmm2tgm.py THIS HEADER COMMENT PREVENTS RECONVERSION, DO NOT REMOVE
"au" = (
/obj/machinery/vending/wallmed,
/turf/closed/wall,
/area/ship/construction)
"aM" = (
/obj/effect/decal/cleanable/dirt,
/obj/effect/decal/cleanable/glass/plasma,
/obj/effect/decal/cleanable/dirt,
/turf/open/floor/plating,
/area/ship/bridge)
"aZ" = (
/obj/effect/decal/cleanable/dirt,
/obj/structure/door_assembly/door_assembly_min{
	obj_integrity = 40
	},
/obj/effect/decal/cleanable/dirt,
/turf/open/floor/plating,
/area/ship/construction)
"cd" = (
/obj/effect/decal/cleanable/robot_debris{
	pixel_x = -5;
	pixel_y = 19;
	desc = "Scrap bits of metal, wire, and ruined electronics"
	},
/obj/effect/decal/cleanable/blood/gibs/limb,
/obj/effect/decal/cleanable/blood/splatter,
/obj/machinery/power/apc/auto_name/north,
/turf/open/floor/plasteel/grimy,
/area/ship/construction)
"ch" = (
/obj/effect/decal/cleanable/dirt/dust,
/obj/machinery/cryopod,
/turf/open/floor/plating,
/area/ship/bridge)
"cm" = (
/obj/structure/girder/displaced,
/turf/open/floor/plating,
/area/ship/bridge)
"ea" = (
/obj/structure/closet/secure_closet/freezer/kitchen{
	name = "kitchen freezer"
	},
/obj/effect/spawner/lootdrop/donkpockets,
/obj/effect/spawner/lootdrop/donkpockets,
/obj/effect/decal/cleanable/food/flour,
/turf/open/floor/plasteel/grimy,
/area/ship/construction)
"eq" = (
/obj/effect/decal/cleanable/dirt,
/turf/closed/wall/r_wall/rust,
/area/ship/bridge)
"eC" = (
/obj/machinery/mineral/equipment_vendor,
/turf/open/floor/plating,
/area/ship/bridge)
"gy" = (
/obj/effect/decal/cleanable/glass,
/turf/closed/mineral/random/asteroid,
/area/ship/external)
"gS" = (
/obj/structure/toilet,
/obj/effect/decal/cleanable/cobweb/cobweb2,
/obj/item/reagent_containers/pill/floorpill{
	pixel_x = 10;
	pixel_y = 12
	},
/obj/effect/decal/cleanable/dirt/dust,
/turf/open/floor/plasteel/tech/techmaint,
/area/ship/construction)
"hb" = (
/obj/item/mop,
/obj/item/reagent_containers/glass/bucket,
/obj/item/clothing/gloves/color/latex/nitrile,
/obj/item/storage/box/lights/mixed,
/obj/item/storage/pill_bottle/charcoal/less,
/obj/structure/closet/wall{
	name = "Utility Closet";
	dir = 8;
	pixel_x = 32
	},
/turf/open/floor/wood/maple,
/area/ship/construction)
"hr" = (
/turf/open/floor/plating/asteroid/airless,
/area/ship/external)
"hQ" = (
/obj/structure/table/wood/bar,
/turf/open/floor/plasteel/grimy,
/area/ship/construction)
"hU" = (
/obj/effect/decal/cleanable/oil/streak,
/obj/item/chair{
	pixel_y = -5
	},
/obj/effect/decal/cleanable/vomit,
/obj/item/reagent_containers/food/drinks/bottle/whiskey{
	list_reagents = list(/datum/reagent/consumable/ethanol/whiskey=10);
	pixel_x = -10;
	pixel_y = 2
	},
/turf/open/floor/plating,
/area/ship/bridge)
"ih" = (
/obj/machinery/door/airlock/public,
/turf/open/floor/plasteel/tech/techmaint,
/area/ship/construction)
"iW" = (
/obj/machinery/power/shuttle/engine/electric{
	dir = 1
	},
/obj/structure/cable{
	cable_color = ssssss
	},
/turf/open/floor/plating,
/area/ship/external)
"le" = (
/obj/effect/decal/cleanable/dirt/dust,
/turf/open/floor/plating,
/area/ship/bridge)
"mc" = (
/obj/machinery/ore_silo,
/obj/machinery/light,
/turf/open/floor/plating,
/area/ship/bridge)
"mN" = (
/obj/item/stack/rods{
	amount = 2
	},
/turf/open/floor/wood/maple,
/area/ship/construction)
"nh" = (
/obj/structure/sink{
	dir = 4;
	pixel_x = -12;
	pixel_y = 2
	},
/obj/machinery/light/small{
	dir = 8;
	pixel_y = 10;
	light_power = 0.25
	},
/obj/effect/decal/cleanable/dirt,
/obj/structure/mirror{
	pixel_x = -26
	},
/turf/open/floor/plasteel/tech/techmaint,
/area/ship/construction)
"nq" = (
/obj/machinery/airalarm/directional/east,
/obj/structure/table/wood/bar,
/obj/structure/window/reinforced,
/obj/machinery/microwave{
	pixel_y = 6
	},
/turf/open/floor/plasteel/grimy,
/area/ship/construction)
"nt" = (
/obj/structure/chair/wood,
/turf/open/floor/wood/maple,
/area/ship/construction)
"nv" = (
/obj/machinery/light/broken{
	dir = 1
	},
/turf/open/floor/plasteel/grimy,
/area/ship/construction)
"oq" = (
/obj/item/chair/stool/bar,
/obj/item/stack/rods{
	amount = 2
	},
/obj/item/shard/plasma,
/obj/effect/decal/cleanable/glass/plasma,
/turf/open/floor/wood/maple,
/area/ship/construction)
"pU" = (
/turf/closed/wall/rust,
/area/ship/construction)
"sw" = (
/obj/structure/rack,
/obj/item/clothing/gloves/color/black,
/obj/item/storage/toolbox/mechanical/old,
/obj/item/stack/sheet/mineral/plasma/five,
/obj/item/areaeditor/shuttle,
/turf/open/floor/plating,
/area/ship/bridge)
"tr" = (
/obj/structure/girder,
/obj/item/stack/sheet/metal{
	amount = 2
	},
/turf/open/floor/plating,
/area/ship/construction)
"vf" = (
/obj/structure/table/wood/poker,
/obj/item/toy/cards/deck{
	pixel_y = 4
	},
/turf/open/floor/wood/maple,
/area/ship/construction)
"vj" = (
/obj/machinery/door/window/southleft{
	name = "Bar_new";
	icon_state = "right"
	},
/turf/open/floor/plasteel/grimy,
/area/ship/construction)
"vk" = (
/obj/machinery/suit_storage_unit/mining/eva{
	storage_type = /obj/item/tank/internals/oxygen
	},
/obj/machinery/airalarm/directional/west,
/obj/machinery/light/broken{
	dir = 1
	},
/turf/open/floor/plating,
/area/ship/bridge)
"wk" = (
/obj/structure/cable{
	icon_state = "4-8"
	},
/obj/machinery/autolathe/hacked,
/turf/open/floor/plating,
/area/ship/bridge)
"xa" = (
/obj/machinery/light/broken,
/obj/item/chair/wood,
/turf/open/floor/wood/cold,
/area/ship/construction)
"xk" = (
/obj/effect/decal/cleanable/dirt/dust,
/obj/effect/decal/cleanable/dirt/dust,
/obj/machinery/computer/cryopod,
/turf/closed/wall/rust,
/area/ship/bridge)
"zr" = (
/turf/closed/wall,
/area/ship/bridge)
"zX" = (
/obj/structure/window/plasma/reinforced/fulltile,
/obj/structure/cable{
	icon_state = "1-2"
	},
/obj/structure/grille,
/obj/structure/sign/warning/electricshock,
/turf/open/floor/plating,
/area/ship/bridge)
"Ab" = (
/obj/structure/chair/stool/bar,
/turf/open/floor/wood/maple,
/area/ship/construction)
"AU" = (
/obj/structure/fans/tiny,
/obj/machinery/door/airlock/external/glass,
/obj/docking_port/mobile{
	dir = 8;
	launch_status = 0;
	port_direction = 4
	},
/turf/open/floor/plating,
/area/ship/bridge)
"CD" = (
/obj/machinery/power/port_gen/pacman{
	anchored = 1;
	can_be_unanchored = 1
	},
/obj/structure/cable{
	icon_state = "0-8"
	},
/obj/structure/cable{
	icon_state = "2-8"
	},
/obj/effect/decal/cleanable/oil,
/turf/open/floor/plating,
/area/ship/bridge)
"Ef" = (
/obj/structure/grille,
/obj/structure/window/reinforced/fulltile,
/turf/open/floor/plating,
/area/ship/construction)
"Fg" = (
/turf/closed/wall/r_wall,
/area/ship/bridge)
"FA" = (
/turf/closed/mineral/random/asteroid,
/area/ship/external)
"FC" = (
/obj/machinery/power/apc/auto_name/south,
/obj/structure/cable{
	icon_state = "0-4"
	},
/obj/structure/rack,
/obj/item/storage/bag/ore,
/obj/item/storage/bag/ore,
/obj/item/pickaxe/rusted,
/obj/item/pickaxe/rusted,
/obj/machinery/light,
/turf/open/floor/plating,
/area/ship/bridge)
"FQ" = (
/obj/effect/decal/cleanable/dirt/dust,
/turf/open/floor/wood/maple,
/area/ship/construction)
"GE" = (
/turf/closed/wall/rust,
/area/ship/bridge)
"Ha" = (
/obj/effect/decal/cleanable/glass/plasma,
/obj/effect/decal/cleanable/dirt/dust,
/turf/open/floor/plating,
/area/ship/bridge)
"Hb" = (
/obj/structure/window/plasma/reinforced/fulltile,
/obj/structure/grille,
/obj/structure/sign/warning/vacuum/external,
/turf/open/floor/plating,
/area/ship/bridge)
"HQ" = (
/obj/structure/lattice/catwalk,
/turf/open/space/basic,
/area/ship/external)
"Il" = (
/obj/item/stack/rods{
	amount = 2
	},
/obj/item/shard/plasma,
/obj/structure/grille/broken,
/obj/effect/decal/cleanable/glass/plasma,
/turf/open/floor/plating,
/area/ship/bridge)
"IX" = (
/turf/template_noop,
/area/template_noop)
"Lh" = (
/obj/effect/decal/cleanable/oil/streak,
/obj/machinery/computer/helm,
/turf/open/floor/plating,
/area/ship/bridge)
"LP" = (
/obj/machinery/vending/cigarette,
/turf/open/floor/wood/maple,
/area/ship/construction)
"LR" = (
/obj/structure/window/plasma/reinforced/fulltile,
/obj/structure/grille,
/turf/open/floor/plating,
/area/ship/bridge)
"MM" = (
/obj/structure/chair/wood{
	dir = 8
	},
/turf/open/floor/wood/maple,
/area/ship/construction)
"Ns" = (
/turf/closed/wall,
/area/ship/construction)
"Oy" = (
/obj/machinery/vending/boozeomat,
/turf/open/floor/plating,
/area/ship/construction)
"OD" = (
/obj/structure/sign/poster/contraband/fun_police,
/turf/closed/wall,
/area/ship/construction)
"OK" = (
/obj/effect/decal/cleanable/blood/gibs/core,
/turf/open/floor/plasteel/grimy,
/area/ship/construction)
"Po" = (
/obj/structure/sign/warning/nosmoking/circle,
/obj/structure/sign/poster/ripped,
/turf/closed/wall,
/area/ship/construction)
"Px" = (
/obj/item/clothing/suit/hooded/explorer,
/obj/item/tank/internals/oxygen,
/obj/item/clothing/mask/gas/explorer,
/obj/structure/rack,
/turf/open/floor/plating,
/area/ship/bridge)
"RK" = (
/obj/item/shard/plasma,
/obj/effect/decal/cleanable/blood/gibs/up,
/obj/item/clothing/head/collectable/tophat,
/obj/effect/decal/cleanable/glass/plasma,
/turf/open/floor/plasteel/grimy,
/area/ship/construction)
"SI" = (
/obj/machinery/mineral/ore_redemption{
	dir = 8;
	input_dir = 4;
	output_dir = 8
	},
/obj/machinery/door/window/eastright,
/obj/machinery/door/window/eastright{
	dir = 8
	},
/obj/structure/fans/tiny,
/turf/open/floor/plating,
/area/ship/bridge)
"Ti" = (
/turf/open/floor/plating,
/area/ship/bridge)
"Tp" = (
/turf/open/floor/wood/maple,
/area/ship/construction)
"TN" = (
/obj/effect/decal/cleanable/dirt,
/obj/effect/decal/cleanable/glass,
/obj/item/shard,
/obj/item/stack/rods{
	amount = 2
	},
/turf/open/floor/plating,
/area/ship/construction)
"Ub" = (
/obj/effect/decal/cleanable/dirt,
/obj/effect/decal/cleanable/oil/streak,
/obj/effect/decal/cleanable/dirt/dust,
/obj/effect/decal/cleanable/glass,
/obj/item/shard,
/obj/item/stack/rods{
	amount = 2
	},
/turf/open/floor/plating,
/area/ship/construction)
"We" = (
/obj/structure/table/wood/poker,
/obj/item/reagent_containers/food/drinks/ale{
	pixel_y = 4;
	pixel_x = 5
	},
/obj/item/reagent_containers/food/drinks/ale{
	pixel_y = 11;
	pixel_x = -5
	},
/turf/open/floor/wood/maple,
/area/ship/construction)
"Xg" = (
/obj/item/chair/stool/bar,
/turf/open/floor/wood/maple,
/area/ship/construction)
"Ye" = (
/obj/effect/decal/cleanable/oil/streak,
/turf/open/floor/plating,
/area/ship/bridge)
"Yo" = (
/obj/structure/table_frame/wood,
/obj/item/stack/sheet/mineral/wood,
/turf/open/floor/plasteel/grimy,
/area/ship/construction)
"YV" = (
/mob/living/simple_animal/hostile/cockroach,
/turf/open/floor/wood/maple,
/area/ship/construction)
"Zo" = (
/obj/effect/decal/cleanable/dirt,
/turf/open/floor/wood/maple,
/area/ship/construction)

(1,1,1) = {"
IX
IX
IX
IX
IX
IX
IX
IX
IX
IX
IX
IX
IX
IX
IX
IX
IX
IX
IX
"}
(2,1,1) = {"
IX
IX
IX
IX
IX
IX
IX
IX
hr
hr
Fg
zr
LR
LR
LR
zr
Fg
IX
IX
"}
(3,1,1) = {"
IX
IX
hr
FA
FA
hr
IX
hr
FA
pU
GE
vk
Ti
Px
Px
FC
zr
IX
IX
"}
(4,1,1) = {"
IX
hr
FA
Ns
Oy
Ef
Ef
Ef
Ns
pU
Il
Ti
Ti
Ti
Ti
wk
LR
HQ
IX
"}
(5,1,1) = {"
IX
FA
FA
Ns
nv
hQ
oq
FQ
Zo
TN
Ha
Lh
hU
eC
Ye
CD
zX
iW
IX
"}
(6,1,1) = {"
IX
FA
FA
Ns
OK
hQ
Xg
Tp
FQ
Ub
aM
le
Ye
Ti
Ti
sw
LR
HQ
IX
"}
(7,1,1) = {"
IX
hr
FA
tr
RK
Yo
Ab
Tp
Tp
aZ
cm
ch
Ti
Ti
Ti
mc
zr
IX
IX
"}
(8,1,1) = {"
IX
hr
FA
Ns
cd
vj
mN
Tp
Tp
xa
eq
xk
Hb
AU
SI
zr
Fg
IX
IX
"}
(9,1,1) = {"
IX
hr
hr
Ns
ea
nq
LP
Tp
nt
vf
pU
FA
IX
IX
IX
IX
IX
IX
IX
"}
(10,1,1) = {"
IX
hr
FA
Ns
Ns
Ns
OD
YV
nt
We
Ns
FA
IX
IX
IX
IX
IX
IX
IX
"}
(11,1,1) = {"
IX
FA
FA
Po
gS
nh
ih
hb
Tp
MM
Ns
FA
IX
IX
IX
IX
IX
IX
IX
"}
(12,1,1) = {"
FA
FA
FA
Ns
Ns
au
Ns
Ns
Ns
Ns
Ns
FA
hr
IX
IX
IX
IX
IX
IX
"}
(13,1,1) = {"
hr
FA
FA
FA
FA
FA
FA
FA
FA
gy
FA
hr
hr
IX
IX
IX
IX
IX
IX
"}
(14,1,1) = {"
IX
hr
FA
FA
FA
FA
hr
FA
FA
FA
hr
hr
IX
IX
IX
IX
IX
IX
IX
"}
(15,1,1) = {"
IX
IX
IX
IX
IX
IX
IX
IX
hr
FA
IX
IX
IX
IX
IX
IX
IX
IX
IX
"}
