//MAP CONVERTED BY dmm2tgm.py THIS HEADER COMMENT PREVENTS RECONVERSION, DO NOT REMOVE
"au" = (
/obj/machinery/vending/wallmed,
/turf/closed/wall,
/area/ship/crew/canteen)
"aM" = (
/obj/effect/decal/cleanable/dirt,
/obj/effect/decal/cleanable/glass/plasma,
/obj/effect/decal/cleanable/dirt,
/turf/open/floor/plating,
/area/ship/bridge)
"aZ" = (
/obj/effect/decal/cleanable/dirt,
/obj/structure/door_assembly/door_assembly_min{
	obj_integrity = 40
	},
/obj/effect/decal/cleanable/dirt,
/turf/open/floor/plating,
/area/ship/crew/canteen)
"bg" = (
/turf/closed/mineral/random/asteroid,
/area/ship/construction)
"cd" = (
/obj/effect/decal/cleanable/robot_debris{
	pixel_x = -5;
	pixel_y = 19;
	desc = "Scrap bits of metal, wire, and ruined electronics"
	},
/obj/effect/decal/cleanable/blood/gibs/limb,
/obj/effect/decal/cleanable/blood/splatter,
/turf/open/floor/plasteel/grimy,
/area/ship/crew/canteen)
"ch" = (
/obj/effect/decal/cleanable/dirt/dust,
/obj/machinery/cryopod,
/turf/open/floor/plating,
/area/ship/bridge)
"cm" = (
/obj/structure/girder/displaced,
/turf/open/floor/plating,
/area/ship/bridge)
"cn" = (
/obj/structure/flora/rock/pile,
/obj/structure/flora/rock{
	desc = "A jagged chunk of broken volcanic rock."
	},
/obj/effect/decal/cleanable/dirt,
/turf/open/floor/plating/asteroid/airless{
	tiled_dirt = 0
	},
/area/ship/construction)
"ea" = (
/turf/open/floor/plasteel/grimy,
/area/ship/crew/canteen)
"eq" = (
/obj/effect/decal/cleanable/dirt,
/turf/closed/wall/r_wall/rust,
/area/ship/bridge)
"eC" = (
/obj/machinery/mineral/equipment_vendor,
/turf/open/floor/plating,
/area/ship/bridge)
"eJ" = (
/obj/structure/sign/poster/contraband/hacking_guide,
/turf/closed/wall,
/area/ship/crew/canteen)
"ga" = (
/obj/machinery/light,
/obj/machinery/power/apc/auto_name/east,
/obj/structure/cable{
	icon_state = "0-8"
	},
/turf/open/floor/plating,
/area/ship/bridge)
"gy" = (
/obj/item/cigbutt,
/turf/open/floor/plating/asteroid/airless{
	tiled_dirt = 0
	},
/area/ship/construction)
"gS" = (
/obj/structure/toilet,
/obj/effect/decal/cleanable/cobweb/cobweb2,
/obj/item/reagent_containers/pill/floorpill{
	pixel_x = 10;
	pixel_y = 12
	},
/obj/effect/decal/cleanable/dirt/dust,
/turf/open/floor/plasteel/tech/techmaint,
/area/ship/crew/canteen)
"hb" = (
/obj/item/mop,
/obj/item/reagent_containers/glass/bucket,
/obj/item/clothing/gloves/color/latex/nitrile,
/obj/item/storage/box/lights/mixed,
/obj/item/storage/pill_bottle/charcoal/less,
/obj/structure/closet/wall{
	name = "Utility Closet";
	dir = 8;
	pixel_x = 32
	},
/turf/open/floor/wood/maple,
/area/ship/crew/canteen)
"hr" = (
/turf/open/floor/plating/asteroid/airless{
	tiled_dirt = 0
	},
/area/ship/construction)
"hQ" = (
/obj/structure/table/wood/bar,
/obj/item/storage/fancy/cigarettes/cigpack_robust,
/obj/item/cigbutt{
	pixel_x = 6
	},
/turf/open/floor/plasteel/grimy,
/area/ship/crew/canteen)
"hU" = (
/obj/effect/decal/cleanable/oil/streak,
/obj/item/chair{
	pixel_y = -5
	},
/obj/effect/decal/cleanable/vomit,
/turf/open/floor/plating,
/area/ship/bridge)
"ih" = (
/obj/machinery/door/airlock/public,
/turf/open/floor/plasteel/tech/techmaint,
/area/ship/crew/canteen)
"iW" = (
/obj/machinery/power/shuttle/engine/electric{
	dir = 1
	},
/obj/structure/cable,
/turf/open/floor/plating,
/area/ship/external)
"le" = (
/obj/effect/decal/cleanable/dirt/dust,
/turf/open/floor/plating,
/area/ship/bridge)
"lz" = (
/obj/structure/table,
/obj/machinery/microwave{
	pixel_y = 6
	},
/turf/open/floor/plating,
/area/ship/crew/canteen)
"lP" = (
/obj/structure/window/plasma/reinforced/fulltile,
/obj/structure/grille,
/obj/structure/sign/warning/electricshock,
/obj/structure/cable{
	icon_state = "2-4"
	},
/turf/open/space/basic,
/area/ship/bridge)
"lY" = (
/obj/effect/decal/cleanable/dirt,
/turf/open/floor/plating,
/area/ship/crew/canteen)
"mc" = (
/obj/machinery/ore_silo,
/obj/machinery/light,
/turf/open/floor/plating,
/area/ship/bridge)
"mN" = (
/obj/item/stack/rods{
	amount = 2
	},
/turf/open/floor/wood/maple,
/area/ship/crew/canteen)
"nh" = (
/obj/structure/sink{
	dir = 4;
	pixel_x = -12;
	pixel_y = 2
	},
/obj/machinery/light/small{
	dir = 8;
	pixel_y = 10;
	light_power = 0.25
	},
/obj/effect/decal/cleanable/dirt,
/obj/structure/mirror{
	pixel_x = -26
	},
/obj/item/cigbutt{
	pixel_x = -13
	},
/turf/open/floor/plasteel/tech/techmaint,
/area/ship/crew/canteen)
"nq" = (
/obj/structure/cable{
	icon_state = "1-8"
	},
/turf/open/floor/plating,
/area/ship/crew/canteen)
"nt" = (
/obj/structure/grille,
/obj/structure/window/reinforced/fulltile,
/turf/open/floor/plating,
/area/ship/crew/canteen)
"nv" = (
/obj/item/sign{
	name = "three";
	desc = "A numeral sign. It can be placed on a wall.";
	icon_state = "3";
	sign_path = /obj/structure/sign/number/three;
	pixel_x = -9;
	pixel_y = -10
	},
/turf/closed/wall/rust,
/area/ship/bridge)
"oq" = (
/obj/item/chair/stool/bar,
/obj/item/stack/rods{
	amount = 2
	},
/obj/item/shard/plasma,
/obj/effect/decal/cleanable/glass/plasma,
/turf/open/floor/wood/maple,
/area/ship/crew/canteen)
"pM" = (
/obj/machinery/suit_storage_unit/mining/eva{
	storage_type = /obj/item/tank/internals/oxygen
	},
/obj/machinery/airalarm/directional/west,
/obj/machinery/light/broken{
	dir = 1
	},
/obj/effect/decal/cleanable/cobweb,
/turf/open/floor/plating,
/area/ship/bridge)
"pU" = (
/obj/structure/table/wood/poker,
/obj/item/toy/cards/deck{
	pixel_y = 4
	},
/turf/open/floor/wood/maple,
/area/ship/crew/canteen)
"qU" = (
/obj/structure/lattice,
/turf/open/space/basic,
/area/ship/external)
"ry" = (
/obj/structure/closet/secure_closet/freezer/kitchen{
	name = "kitchen freezer"
	},
/obj/effect/spawner/lootdrop/donkpockets,
/obj/effect/spawner/lootdrop/donkpockets,
/obj/effect/decal/cleanable/food/flour,
/obj/machinery/light/small{
	dir = 1;
	light_power = 0.25
	},
/turf/open/floor/plating,
/area/ship/crew/canteen)
"rQ" = (
/obj/structure/table/reinforced,
/obj/item/areaeditor/shuttle{
	pixel_y = 1;
	pixel_x = -5
	},
/obj/item/toy/toy_xeno{
	pixel_y = 8;
	pixel_x = -5
	},
/obj/item/broken_bottle{
	pixel_x = 8;
	pixel_y = 2
	},
/turf/open/floor/plating,
/area/ship/bridge)
"sw" = (
/obj/machinery/autolathe/hacked,
/obj/structure/cable{
	icon_state = "4-8"
	},
/turf/open/floor/plating,
/area/ship/bridge)
"tr" = (
/obj/structure/girder,
/obj/item/stack/sheet/metal{
	amount = 2
	},
/turf/open/floor/plating,
/area/ship/crew/canteen)
"vf" = (
/obj/structure/chair/wood,
/turf/open/floor/wood/maple,
/area/ship/crew/canteen)
"vj" = (
/obj/machinery/door/window/southleft{
	name = "Bar_new";
	icon_state = "right";
	obj_integrity = 75
	},
/turf/open/floor/plasteel/grimy,
/area/ship/crew/canteen)
"vk" = (
/obj/machinery/suit_storage_unit/open,
/turf/open/floor/wood/maple,
/area/ship/crew/canteen)
"wk" = (
/obj/structure/rack,
/obj/item/clothing/gloves/color/black,
/obj/item/storage/toolbox/mechanical/old,
/obj/item/stack/tape/industrial/electrical,
/obj/item/stack/sheet/mineral/plasma/five,
/turf/open/floor/plating,
/area/ship/bridge)
"wA" = (
/obj/effect/decal/cleanable/dirt/dust,
/obj/structure/cable{
	icon_state = "4-8"
	},
/turf/open/floor/plating,
/area/ship/crew/canteen)
"wG" = (
/obj/structure/sign/poster/contraband/smoke,
/turf/closed/wall,
/area/ship/crew/canteen)
"xa" = (
/obj/machinery/light/built,
/obj/item/light/tube/broken,
/turf/open/floor/wood/cold,
/area/ship/crew/canteen)
"xk" = (
/obj/effect/decal/cleanable/dirt/dust,
/obj/effect/decal/cleanable/dirt/dust,
/obj/machinery/computer/cryopod,
/turf/closed/wall/rust,
/area/ship/bridge)
"yv" = (
/obj/machinery/suit_storage_unit/standard_unit,
/turf/open/floor/plating,
/area/ship/crew/canteen)
"zr" = (
/turf/closed/wall,
/area/ship/bridge)
"zt" = (
/obj/machinery/door/airlock/maintenance,
/turf/open/floor/plating,
/area/ship/crew/canteen)
"zX" = (
/obj/structure/window/plasma/reinforced/fulltile,
/obj/structure/cable{
	icon_state = "1-2"
	},
/obj/structure/grille,
/obj/structure/sign/warning/electricshock,
/obj/structure/cable{
	icon_state = "1-8"
	},
/turf/open/floor/plating,
/area/ship/bridge)
"Ab" = (
/obj/structure/chair/stool/bar{
	pixel_y = 4
	},
/turf/open/floor/wood/maple,
/area/ship/crew/canteen)
"AU" = (
/obj/structure/fans/tiny,
/obj/machinery/door/airlock/external/glass,
/obj/docking_port/mobile{
	dir = 8;
	launch_status = 0;
	port_direction = 4
	},
/turf/open/floor/plating,
/area/ship/bridge)
"Cc" = (
/obj/structure/window/plasma/reinforced/fulltile{
	obj_integrity = 500
	},
/obj/structure/grille,
/obj/structure/cable{
	icon_state = "0-8"
	},
/turf/open/floor/plating,
/area/ship/crew/canteen)
"CD" = (
/obj/structure/cable{
	icon_state = "0-4"
	},
/obj/structure/rack,
/obj/item/storage/bag/ore,
/obj/item/storage/bag/ore,
/obj/item/pickaxe,
/obj/item/pickaxe,
/obj/item/mining_scanner,
/obj/item/mining_scanner,
/obj/item/stack/marker_beacon/thirty,
/turf/open/floor/plating,
/area/ship/bridge)
"Ef" = (
/turf/open/floor/wood/maple,
/area/ship/crew/canteen)
"ES" = (
/obj/machinery/airalarm/directional/east,
/obj/structure/table/wood/bar,
/obj/item/storage/box/drinkingglasses{
	pixel_y = 4
	},
/turf/open/floor/plasteel/grimy,
/area/ship/crew/canteen)
"Fg" = (
/turf/closed/wall/r_wall,
/area/ship/bridge)
"FA" = (
/turf/closed/wall/rust,
/area/ship/crew/canteen)
"FC" = (
/obj/structure/closet/wall/orange{
	pixel_y = -32;
	dir = 1
	},
/obj/item/stack/medical/bruise_pack,
/obj/item/stack/medical/ointment,
/obj/item/book/manual/ripley_build_and_repair,
/obj/item/reagent_containers/food/drinks/beer,
/obj/item/reagent_containers/food/drinks/beer,
/obj/item/reagent_containers/food/drinks/bottle/absinthe,
/obj/item/reagent_containers/food/drinks/drinkingglass/shotglass,
/obj/item/reagent_containers/food/drinks/drinkingglass/shotglass,
/obj/item/reagent_containers/food/drinks/drinkingglass/shotglass,
/turf/open/floor/plating,
/area/ship/bridge)
"FQ" = (
/obj/effect/decal/cleanable/dirt/dust,
/turf/open/floor/wood/maple,
/area/ship/crew/canteen)
"GE" = (
/obj/structure/sign/number/one{
	pixel_x = -7
	},
/obj/structure/sign/number/three{
	pixel_x = 7
	},
/turf/closed/wall/rust,
/area/ship/bridge)
"Ha" = (
/obj/effect/decal/cleanable/glass/plasma,
/obj/effect/decal/cleanable/dirt/dust,
/turf/open/floor/plating,
/area/ship/bridge)
"Hb" = (
/obj/structure/window/plasma/reinforced/fulltile,
/obj/structure/grille,
/obj/structure/sign/warning/vacuum/external,
/turf/open/floor/plating,
/area/ship/bridge)
"HQ" = (
/obj/structure/lattice/catwalk,
/turf/open/space/basic,
/area/ship/external)
"Il" = (
/obj/item/stack/rods{
	amount = 2
	},
/obj/item/shard/plasma,
/obj/structure/grille/broken,
/obj/effect/decal/cleanable/glass/plasma,
/turf/open/floor/plating,
/area/ship/bridge)
"IX" = (
/turf/template_noop,
/area/template_noop)
"KL" = (
/obj/structure/closet/emcloset/wall{
	dir = 1;
	pixel_y = -32
	},
/obj/item/storage/toolbox/emergency/old,
/obj/item/tank/internals/emergency_oxygen/engi,
/obj/effect/spawner/lootdrop/glowstick,
/obj/effect/spawner/lootdrop/glowstick,
/obj/item/clothing/mask/breath,
/obj/structure/cable{
	icon_state = "4-8"
	},
/turf/open/floor/plating,
/area/ship/crew/canteen)
"KX" = (
/obj/structure/flora/rock/pile,
/obj/effect/decal/cleanable/dirt,
/turf/open/floor/plating/asteroid/airless{
	tiled_dirt = 0
	},
/area/ship/construction)
"Lh" = (
/obj/effect/decal/cleanable/oil/streak,
/obj/machinery/computer/helm,
/turf/open/floor/plating,
/area/ship/bridge)
"LP" = (
/obj/machinery/vending/cigarette{
	pixel_x = 5;
	pixel_y = -2
	},
/turf/open/floor/wood/maple,
/area/ship/crew/canteen)
"LR" = (
/obj/structure/window/plasma/reinforced/fulltile,
/obj/structure/grille,
/turf/open/floor/plating,
/area/ship/bridge)
"MD" = (
/obj/item/stack/cable_coil/cut/red{
	pixel_y = 6
	},
/obj/effect/decal/cleanable/shreds{
	desc = "Some shredded scraps of electrical cable."
	},
/turf/open/floor/plating/asteroid/airless{
	tiled_dirt = 0
	},
/area/ship/construction)
"MM" = (
/obj/structure/sign/poster/contraband/bountyhunters,
/turf/closed/wall,
/area/ship/crew/canteen)
"Ns" = (
/turf/closed/wall,
/area/ship/crew/canteen)
"Oy" = (
/obj/structure/cable{
	icon_state = "2-4"
	},
/turf/open/floor/plating,
/area/ship/crew/canteen)
"OD" = (
/obj/structure/sign/poster/contraband/fun_police,
/turf/closed/wall,
/area/ship/crew/canteen)
"OK" = (
/obj/effect/decal/cleanable/blood/gibs/core,
/obj/machinery/light/broken{
	dir = 1
	},
/obj/item/sign{
	name = "seven";
	desc = "A numeral sign. It can be placed on a wall.";
	icon_state = "7";
	sign_path = /obj/structure/sign/number/seven;
	dir = 1;
	pixel_y = -10
	},
/turf/open/floor/plasteel/grimy,
/area/ship/crew/canteen)
"Pf" = (
/obj/machinery/power/apc/auto_name/south,
/obj/structure/cable{
	icon_state = "0-4"
	},
/turf/open/floor/plating,
/area/ship/crew/canteen)
"Po" = (
/obj/structure/sign/poster/contraband/tools,
/turf/closed/wall,
/area/ship/crew/canteen)
"Px" = (
/obj/item/clothing/suit/hooded/explorer,
/obj/item/tank/internals/oxygen,
/obj/item/clothing/mask/gas/explorer,
/obj/structure/rack,
/obj/effect/decal/cleanable/dirt/dust,
/obj/effect/spawner/lootdrop/glowstick,
/turf/open/floor/plating,
/area/ship/bridge)
"PG" = (
/obj/item/reagent_containers/food/drinks/ale{
	pixel_y = 5;
	pixel_x = 7
	},
/obj/structure/table/wood/poker,
/obj/item/reagent_containers/food/drinks/ale{
	pixel_y = 14;
	pixel_x = -7
	},
/obj/item/cigbutt/cigarbutt{
	pixel_x = -1;
	pixel_y = 2
	},
/turf/open/floor/wood/maple,
/area/ship/crew/canteen)
"RK" = (
/obj/item/shard/plasma,
/obj/effect/decal/cleanable/blood/gibs/up,
/obj/item/clothing/head/collectable/tophat,
/obj/effect/decal/cleanable/glass/plasma,
/turf/open/floor/plasteel/grimy,
/area/ship/crew/canteen)
"SI" = (
/obj/machinery/mineral/ore_redemption{
	dir = 8;
	input_dir = 4;
	output_dir = 8
	},
/obj/machinery/door/window/eastright,
/obj/machinery/door/window/eastright{
	dir = 8
	},
/obj/structure/fans/tiny,
/turf/open/floor/plating,
/area/ship/bridge)
"SR" = (
/obj/structure/chair/wood{
	dir = 8
	},
/obj/item/clothing/head/hardhat/mining{
	pixel_x = 8;
	pixel_y = -10
	},
/turf/open/floor/wood/maple,
/area/ship/crew/canteen)
"Tb" = (
/obj/structure/table/wood/bar,
/turf/open/floor/plasteel/grimy,
/area/ship/crew/canteen)
"Ti" = (
/turf/open/floor/plating,
/area/ship/bridge)
"Tp" = (
/obj/item/chair/wood,
/turf/open/floor/wood/maple,
/area/ship/crew/canteen)
"Tx" = (
/obj/machinery/power/port_gen/pacman{
	anchored = 1;
	can_be_unanchored = 1
	},
/obj/effect/decal/cleanable/oil,
/obj/effect/decal/cleanable/plasma,
/obj/structure/cable{
	icon_state = "2-4"
	},
/turf/open/floor/plating,
/area/ship/bridge)
"TN" = (
/obj/effect/decal/cleanable/dirt,
/obj/effect/decal/cleanable/glass,
/obj/item/shard,
/obj/item/stack/rods{
	amount = 2
	},
/turf/open/floor/plating,
/area/ship/crew/canteen)
"Ub" = (
/obj/effect/decal/cleanable/dirt,
/obj/effect/decal/cleanable/oil/streak,
/obj/effect/decal/cleanable/dirt/dust,
/obj/effect/decal/cleanable/glass,
/obj/item/shard,
/obj/item/stack/rods{
	amount = 2
	},
/turf/open/floor/plating,
/area/ship/crew/canteen)
"Vl" = (
/obj/effect/decal/cleanable/dirt,
/turf/open/floor/plating/asteroid/airless{
	tiled_dirt = 0
	},
/area/ship/construction)
"Vq" = (
/obj/structure/rack,
/obj/item/storage/toolbox/mechanical/old,
/obj/item/stack/cable_coil/red,
/obj/item/flashlight/lantern,
/obj/machinery/light/small{
	dir = 8;
	light_power = 0.25
	},
/turf/open/floor/plating,
/area/ship/crew/canteen)
"Vr" = (
/obj/item/storage/secure/safe,
/turf/closed/wall,
/area/ship/crew/canteen)
"We" = (
/obj/effect/decal/cleanable/glass,
/turf/closed/mineral/random/asteroid,
/area/ship/construction)
"Ws" = (
/obj/item/clothing/suit/hooded/explorer,
/obj/item/tank/internals/oxygen,
/obj/item/clothing/mask/gas/explorer,
/obj/structure/rack,
/obj/effect/spawner/lootdrop/glowstick,
/turf/open/floor/plating,
/area/ship/bridge)
"Xg" = (
/obj/item/chair/stool/bar,
/turf/open/floor/wood/maple,
/area/ship/crew/canteen)
"Ya" = (
/obj/structure/cable{
	icon_state = "1-8"
	},
/obj/structure/flora/rock/pile,
/obj/effect/decal/cleanable/dirt,
/turf/open/floor/plating/asteroid/airless{
	tiled_dirt = 0
	},
/area/ship/construction)
"Ye" = (
/obj/effect/decal/cleanable/oil/streak,
/turf/open/floor/plating,
/area/ship/bridge)
"Yg" = (
/turf/open/floor/plating,
/area/ship/crew/canteen)
"Yo" = (
/obj/structure/table_frame/wood,
/obj/item/stack/sheet/mineral/wood,
/turf/open/floor/plasteel/grimy,
/area/ship/crew/canteen)
"YI" = (
/obj/machinery/vending/boozeomat,
/obj/structure/window/reinforced,
/turf/open/floor/plating,
/area/ship/crew/canteen)
"YM" = (
/obj/structure/chair/stool/bar{
	pixel_x = 4
	},
/turf/open/floor/wood/maple,
/area/ship/crew/canteen)
"YV" = (
/mob/living/simple_animal/hostile/cockroach,
/turf/open/floor/wood/maple,
/area/ship/crew/canteen)
"Zi" = (
/obj/structure/cable{
	icon_state = "1-2"
	},
/obj/structure/marker_beacon,
/turf/open/floor/plating/asteroid/airless{
	tiled_dirt = 0
	},
/area/ship/construction)
"Zo" = (
/obj/effect/decal/cleanable/dirt,
/turf/open/floor/wood/maple,
/area/ship/crew/canteen)

(1,1,1) = {"
IX
IX
IX
IX
IX
IX
IX
IX
IX
IX
IX
IX
IX
IX
IX
IX
IX
IX
IX
IX
IX
IX
IX
"}
(2,1,1) = {"
IX
IX
IX
IX
hr
bg
IX
bg
bg
IX
IX
IX
qU
IX
Fg
zr
LR
LR
LR
zr
Fg
IX
IX
"}
(3,1,1) = {"
IX
IX
IX
Vl
bg
bg
cn
bg
Ns
nt
nt
nt
Ns
qU
GE
pM
Ws
Px
CD
mc
zr
IX
IX
"}
(4,1,1) = {"
IX
IX
IX
bg
bg
bg
bg
bg
Ns
vk
vk
vk
Ns
FA
nv
Ye
Ti
Ti
le
FC
zr
HQ
IX
"}
(5,1,1) = {"
IX
IX
KX
bg
Ns
ry
lz
eJ
Ns
YM
Ef
Ef
Zo
TN
Il
rQ
Ti
Ti
Ti
wk
lP
iW
IX
"}
(6,1,1) = {"
IX
IX
bg
bg
OD
lY
Pf
Ns
OK
hQ
oq
FQ
Zo
TN
Ha
Lh
hU
eC
Ye
Tx
zX
iW
IX
"}
(7,1,1) = {"
IX
IX
bg
bg
Vr
Yg
wA
tr
RK
Yo
Xg
Ef
FQ
Ub
aM
le
Ti
Ti
Ti
sw
zr
HQ
IX
"}
(8,1,1) = {"
IX
bg
bg
bg
Vq
Yg
KL
Ns
cd
Tb
Ab
Ef
Zo
aZ
cm
ch
Ti
Ti
Ti
ga
zr
IX
IX
"}
(9,1,1) = {"
IX
KX
Vl
bg
yv
Oy
nq
zt
ea
vj
mN
Ef
Tp
xa
eq
xk
Hb
AU
SI
zr
Fg
IX
IX
"}
(10,1,1) = {"
IX
IX
hr
bg
Ns
Cc
Ns
Ns
ES
YI
LP
Ef
Ef
vf
pU
FA
qU
IX
IX
IX
IX
IX
IX
"}
(11,1,1) = {"
IX
IX
IX
MD
Zi
Ya
bg
Ns
Ns
Ns
wG
YV
Ef
vf
PG
Ns
bg
IX
IX
IX
IX
IX
IX
"}
(12,1,1) = {"
IX
IX
IX
IX
gy
bg
bg
Po
gS
nh
ih
hb
Ef
Ef
SR
Ns
bg
IX
IX
IX
IX
IX
IX
"}
(13,1,1) = {"
IX
IX
IX
IX
bg
bg
bg
Ns
Ns
au
Ns
Ns
Ns
MM
Ns
Ns
bg
IX
IX
IX
IX
IX
IX
"}
(14,1,1) = {"
IX
IX
IX
IX
hr
bg
bg
bg
bg
bg
bg
bg
bg
bg
We
bg
KX
IX
IX
IX
IX
IX
IX
"}
(15,1,1) = {"
IX
IX
IX
IX
IX
KX
bg
bg
KX
bg
KX
Vl
Vl
bg
bg
Vl
IX
IX
IX
IX
IX
IX
IX
"}
(16,1,1) = {"
IX
IX
IX
IX
IX
IX
hr
bg
IX
IX
IX
IX
hr
hr
hr
IX
IX
IX
IX
IX
IX
IX
IX
"}
(17,1,1) = {"
IX
IX
IX
IX
IX
IX
IX
IX
IX
IX
IX
IX
IX
IX
IX
IX
IX
IX
IX
IX
IX
IX
IX
"}
