//MAP CONVERTED BY dmm2tgm.py THIS HEADER COMMENT PREVENTS RECONVERSION, DO NOT REMOVE
"a" = (
/turf/template_noop,
/area/template_noop)
"c" = (
/obj/structure/flora/tree/jungle,
/turf/template_noop,
/area/template_noop)
"e" = (
/obj/structure/spider/stickyweb,
/obj/item/reagent_containers/food/snacks/spidereggs,
/turf/open/floor/plating/dirt/jungle,
/area/ruin/unpowered)
"f" = (
/obj/structure/spider/stickyweb,
/turf/open/floor/plating/dirt/jungle,
/area/ruin/unpowered)
"g" = (
/mob/living/simple_animal/hostile/poison/giant_spider/tarantula,
/turf/template_noop,
/area/template_noop)
"i" = (
/obj/effect/decal/cleanable/dirt/dust,
/turf/template_noop,
/area/template_noop)
"j" = (
/obj/effect/decal/cleanable/glass,
/obj/structure/barricade/wooden,
/obj/structure/grille/broken,
/obj/effect/decal/cleanable/dirt/dust,
/turf/open/floor/plating,
/area/ruin/unpowered)
"k" = (
/obj/effect/decal/remains/human,
/obj/item/clothing/head/helmet/swat/nanotrasen,
/obj/effect/decal/cleanable/blood,
/turf/open/floor/plating,
/area/ruin/unpowered)
"l" = (
/obj/structure/spider/spiderling,
/turf/open/floor/plating/dirt/jungle/dark,
/area/ruin/unpowered)
"m" = (
/mob/living/simple_animal/hostile/poison/giant_spider/nurse,
/turf/open/floor/plating/dirt/jungle,
/area/ruin/unpowered)
"o" = (
/obj/structure/spider/stickyweb,
/turf/open/floor/plating/dirt/jungle/dark,
/area/ruin/unpowered)
"q" = (
/obj/effect/decal/cleanable/glass,
/obj/structure/barricade/wooden,
/obj/structure/grille/broken,
/turf/open/floor/plating/dirt/jungle,
/area/ruin/unpowered)
"r" = (
/obj/structure/spider/stickyweb,
/turf/template_noop,
/area/template_noop)
"s" = (
/turf/open/floor/plating,
/area/ruin/unpowered)
"t" = (
/obj/structure/spider/spiderling,
/turf/template_noop,
/area/template_noop)
"u" = (
/obj/structure/spider/stickyweb,
/obj/effect/decal/cleanable/dirt/dust,
/turf/open/floor/plating/dirt/jungle,
/area/ruin/unpowered)
"v" = (
/obj/structure/spider/spiderling,
/obj/structure/spider/cocoon,
/obj/item/pda/geneticist,
/obj/effect/decal/cleanable/blood,
/obj/effect/decal/cleanable/dirt/dust,
/turf/open/floor/plating/dirt/jungle,
/area/ruin/unpowered)
"w" = (
/obj/machinery/clonepod,
/turf/open/floor/plating,
/area/ruin/unpowered)
"x" = (
/obj/effect/decal/cleanable/insectguts,
/turf/open/floor/plating,
/area/ruin/unpowered)
"A" = (
/obj/structure/closet/wardrobe/genetics_white,
/turf/open/floor/plating,
/area/ruin/unpowered)
"C" = (
/obj/item/storage/belt/security/webbing,
/turf/open/floor/plating/dirt/jungle/dark,
/area/ruin/unpowered)
"D" = (
/obj/effect/decal/cleanable/ash/large,
/turf/open/floor/plating,
/area/ruin/unpowered)
"G" = (
/obj/structure/spider/spiderling,
/obj/structure/spider/cocoon,
/turf/open/floor/plating,
/area/ruin/unpowered)
"I" = (
/obj/structure/spider/stickyweb,
/obj/item/organ/heart/gland/spiderman,
/turf/open/floor/plating,
/area/ruin/unpowered)
"K" = (
/turf/closed/wall/rust,
/area/ruin/unpowered)
"L" = (
/obj/effect/decal/cleanable/glass,
/obj/structure/barricade/wooden,
/obj/structure/grille/broken,
/obj/effect/decal/cleanable/dirt/dust,
/turf/open/floor/plating/dirt/jungle,
/area/ruin/unpowered)
"M" = (
/obj/structure/spider/spiderling,
/obj/effect/decal/cleanable/insectguts,
/turf/template_noop,
/area/template_noop)
"N" = (
/obj/effect/decal/cleanable/cobweb/cobweb2,
/mob/living/simple_animal/hostile/poison/giant_spider/nurse,
/turf/open/floor/plating/dirt/jungle/dark,
/area/ruin/unpowered)
"O" = (
/obj/item/melee/flyswatter,
/obj/item/reagent_containers/spray/pestspray,
/turf/template_noop,
/area/template_noop)
"P" = (
/obj/effect/decal/cleanable/glass,
/obj/structure/barricade/wooden,
/obj/structure/grille/broken,
/obj/structure/spider/stickyweb,
/turf/open/floor/plating,
/area/ruin/unpowered)
"Q" = (
/obj/effect/decal/cleanable/glass,
/obj/structure/barricade/wooden,
/obj/structure/grille/broken,
/turf/open/floor/plating,
/area/ruin/unpowered)
"T" = (
/obj/effect/decal/cleanable/dirt/dust,
/turf/open/floor/plating,
/area/ruin/unpowered)
"U" = (
/obj/structure/spider/stickyweb,
/obj/effect/decal/cleanable/insectguts,
/turf/open/floor/plating/dirt/jungle/dark,
/area/ruin/unpowered)
"V" = (
/obj/effect/decal/cleanable/insectguts,
/turf/template_noop,
/area/template_noop)
"W" = (
/obj/item/flamethrower,
/obj/item/tank/internals/plasma/full,
/obj/effect/decal/cleanable/dirt/dust,
/turf/open/floor/plating/dirt/jungle/dark,
/area/ruin/unpowered)
"X" = (
/obj/effect/decal/cleanable/cobweb,
/obj/structure/spider/stickyweb,
/mob/living/simple_animal/hostile/poison/giant_spider,
/obj/item/reagent_containers/food/snacks/spidereggs,
/obj/effect/decal/cleanable/dirt/dust,
/turf/open/floor/plating,
/area/ruin/unpowered)

(1,1,1) = {"
K
K
K
P
K
K
M
a
a
"}
(2,1,1) = {"
K
X
e
f
v
L
r
i
c
"}
(3,1,1) = {"
K
I
u
m
A
K
r
r
r
"}
(4,1,1) = {"
K
U
l
W
w
o
r
r
t
"}
(5,1,1) = {"
P
f
C
k
s
x
O
a
V
"}
(6,1,1) = {"
q
N
T
D
G
j
i
g
a
"}
(7,1,1) = {"
K
K
Q
K
K
K
r
a
a
"}
