//MAP CONVERTED BY dmm2tgm.py THIS HEADER COMMENT PREVENTS RECONVERSION, DO NOT REMOVE
"a" = (
/turf/template_noop,
/area/template_noop)
"c" = (
/mob/living/carbon/monkey/angry,
/obj/item/spear/bonespear,
/turf/open/floor/plating/dirt/jungle/dark,
/area/overmap_encounter/planetoid/jungle)
"m" = (
/obj/structure/flora/rock/jungle,
/turf/open/floor/plating/grass/jungle,
/area/overmap_encounter/planetoid/jungle)
"s" = (
/obj/structure/flora/ausbushes/leafybush,
/turf/open/floor/plating/grass/jungle,
/area/overmap_encounter/planetoid/jungle)
"u" = (
/obj/structure/flora/ausbushes/fullgrass,
/turf/open/floor/plating/grass/jungle,
/area/overmap_encounter/planetoid/jungle)
"w" = (
/obj/structure/flora/ausbushes/grassybush,
/turf/open/floor/plating/grass/jungle,
/area/overmap_encounter/planetoid/jungle)
"x" = (
/obj/structure/flora/junglebush/b,
/turf/open/floor/plating/grass/jungle,
/area/overmap_encounter/planetoid/jungle)
"J" = (
/turf/open/floor/plating/dirt/jungle/dark,
/area/overmap_encounter/planetoid/jungle)
"K" = (
/obj/structure/flora/junglebush/large,
/turf/open/floor/plating/grass/jungle,
/area/overmap_encounter/planetoid/jungle)
"L" = (
/obj/structure/flora/junglebush,
/turf/open/floor/plating/grass/jungle,
/area/overmap_encounter/planetoid/jungle)
"M" = (
/turf/open/floor/plating/grass/jungle,
/area/overmap_encounter/planetoid/jungle)
"N" = (
/obj/structure/bonfire/prelit,
/turf/open/floor/plating/dirt/jungle/dark,
/area/overmap_encounter/planetoid/jungle)
"Q" = (
/obj/machinery/washing_machine{
	color = "#222222";
	desc = "It's a washing machine.";
	name = "obelisk of enlightenment"
	},
/turf/open/floor/plating/dirt/jungle/dark,
/area/overmap_encounter/planetoid/jungle)
"S" = (
/mob/living/carbon/monkey/angry,
/turf/open/floor/plating/dirt/jungle/dark,
/area/overmap_encounter/planetoid/jungle)

(1,1,1) = {"
a
a
a
a
a
a
a
a
a
a
"}
(2,1,1) = {"
a
a
a
M
m
M
J
a
a
a
"}
(3,1,1) = {"
a
a
w
J
J
J
J
s
a
a
"}
(4,1,1) = {"
a
a
J
J
J
J
J
S
L
a
"}
(5,1,1) = {"
a
a
Q
c
J
J
J
J
J
a
"}
(6,1,1) = {"
a
a
J
J
c
J
J
N
J
a
"}
(7,1,1) = {"
a
a
M
J
J
J
J
J
S
a
"}
(8,1,1) = {"
a
a
K
u
M
J
S
J
a
a
"}
(9,1,1) = {"
a
a
a
a
m
M
x
J
a
a
"}
(10,1,1) = {"
a
a
a
a
a
a
a
a
a
a
"}
