//MAP CONVERTED BY dmm2tgm.py THIS HEADER COMMENT PREVENTS RECONVERSION, DO NOT REMOVE
"au" = (
/obj/structure/flora/junglebush/large,
/turf/open/water/jungle,
/area/ruin/unpowered)
"ez" = (
/obj/item/reagent_containers/food/snacks/grown/tomato/blood,
/turf/open/floor/grass,
/area/ruin/unpowered)
"fj" = (
/obj/structure/fence,
/obj/effect/decal/cleanable/blood/gibs/up,
/turf/open/floor/grass,
/area/ruin/unpowered)
"hJ" = (
/obj/effect/decal/cleanable/blood/old,
/turf/open/floor/grass,
/area/ruin/unpowered)
"iB" = (
/obj/structure/fence{
	dir = 4
	},
/turf/open/floor/grass,
/area/ruin/unpowered)
"iJ" = (
/obj/structure/flora/junglebush/c,
/turf/open/water/jungle,
/area/ruin/unpowered)
"lk" = (
/obj/structure/flora/ausbushes,
/turf/template_noop,
/area/template_noop)
"mh" = (
/obj/structure/flora/grass/jungle,
/turf/open/floor/grass,
/area/ruin/unpowered)
"ms" = (
/obj/structure/flora/rock/pile/largejungle,
/turf/open/water/jungle,
/area/ruin/unpowered)
"mt" = (
/obj/structure/flora/tree/jungle/small,
/turf/template_noop,
/area/template_noop)
"my" = (
/obj/structure/flora/rock/jungle,
/turf/template_noop,
/area/template_noop)
"nr" = (
/obj/structure/fence,
/obj/effect/decal/cleanable/blood/gibs/down,
/turf/open/floor/grass,
/area/ruin/unpowered)
"oI" = (
/obj/structure/fence/corner{
	dir = 5
	},
/turf/open/floor/plating/dirt/jungle,
/area/ruin/unpowered)
"pl" = (
/obj/structure/flora/ausbushes/lavendergrass,
/turf/template_noop,
/area/template_noop)
"pN" = (
/obj/effect/decal/cleanable/leaper_sludge,
/turf/template_noop,
/area/template_noop)
"rN" = (
/obj/structure/flora/junglebush/large,
/turf/template_noop,
/area/template_noop)
"rZ" = (
/obj/item/organ/eyes/night_vision/mushroom,
/turf/open/water/jungle,
/area/ruin/unpowered)
"tz" = (
/obj/structure/fence/door/opened,
/turf/open/floor/grass,
/area/ruin/unpowered)
"uX" = (
/obj/structure/flora/ausbushes/palebush,
/obj/effect/decal/cleanable/blood/gibs/limb,
/obj/effect/decal/cleanable/dirt,
/turf/open/floor/grass,
/area/ruin/unpowered)
"uY" = (
/obj/structure/flora/ausbushes/genericbush,
/obj/effect/decal/cleanable/dirt,
/turf/template_noop,
/area/template_noop)
"vy" = (
/obj/structure/flora/ausbushes/pointybush,
/turf/template_noop,
/area/template_noop)
"vB" = (
/obj/structure/flora/rock/pile/largejungle,
/turf/template_noop,
/area/template_noop)
"vY" = (
/obj/structure/fence,
/obj/effect/decal/cleanable/dirt,
/turf/open/floor/grass,
/area/ruin/unpowered)
"wa" = (
/obj/effect/decal/cleanable/dirt,
/turf/template_noop,
/area/template_noop)
"wW" = (
/obj/structure/flora/rock/jungle,
/turf/open/water/jungle,
/area/ruin/unpowered)
"xV" = (
/obj/structure/flora/ausbushes/ywflowers,
/obj/effect/decal/cleanable/blood/old,
/turf/open/floor/grass,
/area/ruin/unpowered)
"yj" = (
/obj/structure/fence/corner,
/turf/open/floor/grass,
/area/ruin/unpowered)
"zG" = (
/obj/structure/flora/tree/jungle,
/turf/template_noop,
/area/template_noop)
"BS" = (
/obj/structure/flora/ausbushes/fullgrass,
/turf/open/water/jungle,
/area/ruin/unpowered)
"Cy" = (
/obj/structure/flora/ausbushes/leafybush,
/turf/template_noop,
/area/template_noop)
"Ij" = (
/obj/item/organ/ears/penguin,
/turf/open/water/jungle,
/area/ruin/unpowered)
"Io" = (
/obj/item/seeds/cocoapod/bungotree,
/turf/template_noop,
/area/template_noop)
"ID" = (
/obj/structure/fence{
	dir = 8
	},
/turf/open/floor/plating/dirt/jungle/dark,
/area/ruin/unpowered)
"JL" = (
/turf/open/water/jungle,
/area/ruin/unpowered)
"Lt" = (
/mob/living/simple_animal/hostile/jungle/seedling{
	health = 300;
	maxHealth = 300
	},
/obj/item/ship_in_a_bottle,
/turf/open/water/jungle,
/area/ruin/unpowered)
"MM" = (
/obj/effect/decal/cleanable/insectguts,
/turf/template_noop,
/area/template_noop)
"OK" = (
/obj/effect/decal/cleanable/insectguts,
/obj/effect/decal/cleanable/dirt,
/turf/template_noop,
/area/template_noop)
"Pg" = (
/obj/structure/flora/ausbushes/reedbush,
/obj/item/organ/heart/cursed,
/turf/open/water/jungle,
/area/ruin/unpowered)
"Py" = (
/obj/structure/flora/rock/pile,
/obj/effect/decal/cleanable/blood/old,
/turf/open/floor/grass,
/area/ruin/unpowered)
"Qe" = (
/obj/effect/mob_spawn/human/corpse/cargo_tech,
/turf/open/water/jungle,
/area/ruin/unpowered)
"QF" = (
/obj/effect/decal/cleanable/blood/gibs/torso,
/turf/open/floor/grass,
/area/ruin/unpowered)
"QV" = (
/obj/item/organ/liver/plasmaman,
/turf/open/water/jungle,
/area/ruin/unpowered)
"Rg" = (
/obj/effect/decal/cleanable/blood/gibs/body,
/turf/template_noop,
/area/template_noop)
"RO" = (
/turf/open/floor/grass,
/area/ruin/unpowered)
"SA" = (
/obj/structure/fence,
/turf/open/floor/grass,
/area/ruin/unpowered)
"SH" = (
/obj/structure/fence{
	dir = 8
	},
/turf/open/floor/grass,
/area/ruin/unpowered)
"SI" = (
/obj/structure/flora/tree/jungle/small,
/turf/open/floor/grass,
/area/ruin/unpowered)
"ST" = (
/obj/effect/decal/cleanable/insectguts,
/turf/open/floor/grass,
/area/ruin/unpowered)
"TD" = (
/obj/structure/fence/corner{
	dir = 1
	},
/turf/open/floor/plating/dirt/jungle,
/area/ruin/unpowered)
"Uv" = (
/obj/structure/flora/ausbushes/reedbush,
/turf/open/water/jungle,
/area/ruin/unpowered)
"Vf" = (
/obj/structure/flora/ausbushes/reedbush,
/obj/item/organ/tongue/lizard,
/turf/open/water/jungle,
/area/ruin/unpowered)
"Vu" = (
/obj/structure/flora/ausbushes/brflowers,
/turf/template_noop,
/area/template_noop)
"VB" = (
/obj/structure/flora/ausbushes/ppflowers,
/obj/effect/decal/cleanable/dirt,
/turf/template_noop,
/area/template_noop)
"WR" = (
/obj/structure/fence/corner{
	dir = 8
	},
/obj/effect/decal/cleanable/dirt,
/turf/open/floor/plating/dirt/jungle,
/area/ruin/unpowered)
"ZE" = (
/turf/template_noop,
/area/template_noop)

(1,1,1) = {"
ZE
ZE
ZE
ZE
ZE
pl
ZE
ZE
ZE
ZE
ZE
"}
(2,1,1) = {"
ZE
ZE
lk
wa
rN
ZE
OK
vB
zG
ZE
ZE
"}
(3,1,1) = {"
ZE
ZE
WR
SA
vY
nr
SA
SA
TD
ZE
ZE
"}
(4,1,1) = {"
pl
ZE
ID
mh
ez
Ij
Py
uX
iB
lk
ZE
"}
(5,1,1) = {"
ZE
mt
SH
hJ
Vf
JL
wW
ST
iB
wa
ZE
"}
(6,1,1) = {"
pN
uY
SH
Uv
BS
Qe
JL
Pg
SH
Rg
my
"}
(7,1,1) = {"
wa
Vu
SH
au
JL
Lt
JL
JL
tz
ZE
wa
"}
(8,1,1) = {"
ZE
wa
SH
QF
rZ
JL
JL
iJ
iB
ZE
pN
"}
(9,1,1) = {"
ZE
ZE
SH
RO
SI
ms
QV
xV
iB
vy
pl
"}
(10,1,1) = {"
ZE
lk
oI
SA
SA
SA
vY
fj
yj
ZE
ZE
"}
(11,1,1) = {"
ZE
ZE
ZE
ZE
MM
VB
Io
lk
Cy
wa
ZE
"}
