//MAP CONVERTED BY dmm2tgm.py THIS HEADER COMMENT PREVENTS RECONVERSION, DO NOT REMOVE
"a" = (
/turf/template_noop,
/area/template_noop)
"b" = (
/turf/closed/mineral/random/high_chance/wasteland,
/area/overmap_encounter/planetoid/wasteland)
"c" = (
/turf/open/floor/plating/wasteland/lit,
/area/ruin/outdoors)
"d" = (
/obj/structure/stone_tile/block{
	dir = 8
	},
/turf/open/floor/plating/dust/lit,
/area/ruin/outdoors)
"e" = (
/obj/structure/stone_tile{
	dir = 8
	},
/turf/open/floor/plating/dust/lit,
/area/ruin/outdoors)
"f" = (
/obj/structure/stone_tile/cracked{
	dir = 1
	},
/turf/open/floor/plating/dust/lit,
/area/ruin/outdoors)
"g" = (
/obj/structure/stone_tile/cracked{
	dir = 8
	},
/turf/open/floor/plating/dust/lit,
/area/ruin/outdoors)
"h" = (
/obj/structure/stone_tile/block{
	dir = 4
	},
/turf/open/floor/plating/dust/lit,
/area/ruin/outdoors)
"i" = (
/obj/structure/stone_tile{
	dir = 4
	},
/turf/open/floor/plating/wasteland/lit,
/area/ruin/outdoors)
"j" = (
/obj/structure/stone_tile,
/turf/open/floor/plating/dust/lit,
/area/ruin/outdoors)
"k" = (
/obj/structure/stone_tile/cracked{
	dir = 4
	},
/turf/open/floor/plating/wasteland/lit,
/area/ruin/outdoors)
"l" = (
/obj/structure/stone_tile,
/obj/structure/stone_tile{
	dir = 4
	},
/turf/open/floor/plating/dust/lit,
/area/ruin/outdoors)
"m" = (
/obj/structure/stone_tile/cracked{
	dir = 8
	},
/obj/structure/stone_tile{
	dir = 1
	},
/turf/open/floor/plating/dust/lit,
/area/ruin/outdoors)
"n" = (
/obj/structure/stone_tile/block/cracked{
	dir = 4
	},
/turf/open/floor/plating/dust/lit,
/area/ruin/outdoors)
"o" = (
/obj/structure/stone_tile/block,
/turf/open/floor/plating/dust/lit,
/area/ruin/outdoors)
"p" = (
/obj/structure/stone_tile/block/cracked{
	dir = 1
	},
/turf/open/floor/plating/dust/lit,
/area/ruin/outdoors)
"q" = (
/obj/structure/stone_tile{
	dir = 4
	},
/obj/structure/stone_tile{
	dir = 1
	},
/turf/open/floor/plating/dust/lit,
/area/ruin/outdoors)
"r" = (
/obj/structure/stone_tile/block{
	dir = 1
	},
/turf/open/floor/plating/dust/lit,
/area/ruin/outdoors)
"s" = (
/obj/structure/stone_tile/block,
/obj/structure/stone_tile/cracked{
	dir = 4
	},
/turf/open/floor/plating/dust/lit,
/area/ruin/outdoors)
"t" = (
/obj/structure/stone_tile/surrounding/cracked{
	dir = 6
	},
/mob/living/simple_animal/hostile/megafauna/blood_drunk_miner{
	dir = 1
	},
/turf/open/floor/plating/dust/lit,
/area/ruin/outdoors)
"u" = (
/obj/structure/stone_tile{
	dir = 1
	},
/obj/structure/stone_tile/block/cracked,
/turf/open/floor/plating/dust/lit,
/area/ruin/outdoors)
"v" = (
/obj/structure/stone_tile{
	dir = 4
	},
/obj/structure/stone_tile/cracked,
/turf/open/floor/plating/dust/lit,
/area/ruin/outdoors)
"w" = (
/obj/structure/stone_tile,
/obj/structure/stone_tile/block/cracked{
	dir = 8
	},
/turf/open/floor/plating/dust/lit,
/area/ruin/outdoors)
"x" = (
/obj/structure/stone_tile{
	dir = 8
	},
/obj/structure/stone_tile/block{
	dir = 1
	},
/turf/open/floor/plating/dust/lit,
/area/ruin/outdoors)
"y" = (
/obj/structure/stone_tile/cracked,
/turf/open/floor/plating/dust/lit,
/area/ruin/outdoors)
"P" = (
/obj/structure/stone_tile,
/turf/open/floor/plating/wasteland/lit,
/area/ruin/outdoors)
"R" = (
/obj/structure/stone_tile{
	dir = 8
	},
/turf/open/floor/plating/wasteland/lit,
/area/ruin/outdoors)
"U" = (
/turf/open/floor/plating/dust/lit,
/area/ruin/outdoors)
"Y" = (
/obj/structure/stone_tile/block/cracked{
	dir = 1
	},
/turf/open/floor/plating/wasteland/lit,
/area/ruin/outdoors)

(1,1,1) = {"
a
a
a
b
b
b
b
b
b
a
a
a
a
a
"}
(2,1,1) = {"
a
a
b
b
c
c
b
b
b
b
b
b
a
a
"}
(3,1,1) = {"
b
b
b
c
d
c
c
b
b
b
b
b
b
a
"}
(4,1,1) = {"
b
b
c
c
k
o
c
U
c
c
b
b
b
b
"}
(5,1,1) = {"
b
c
d
g
c
p
c
v
c
c
c
c
b
b
"}
(6,1,1) = {"
b
c
c
h
l
R
s
P
c
d
e
c
c
b
"}
(7,1,1) = {"
b
c
c
c
c
q
t
w
x
y
Y
e
c
b
"}
(8,1,1) = {"
b
c
e
i
m
P
u
R
c
f
d
y
c
b
"}
(9,1,1) = {"
b
c
f
j
c
r
c
o
c
c
c
c
b
b
"}
(10,1,1) = {"
b
b
c
c
c
o
c
U
b
b
c
b
b
b
"}
(11,1,1) = {"
b
b
b
c
n
c
c
b
b
b
b
b
b
a
"}
(12,1,1) = {"
a
b
b
c
c
c
b
b
b
b
b
a
a
a
"}
(13,1,1) = {"
a
a
b
b
b
b
b
a
a
a
a
a
a
a
"}
