//MAP CONVERTED BY dmm2tgm.py THIS HEADER COMMENT PREVENTS RECONVERSION, DO NOT REMOVE
"ai" = (
/mob/living/simple_animal/hostile/asteroid/goliath{
	dir = 4
	},
/turf/template_noop,
/area/ruin/outdoors)
"an" = (
/obj/machinery/door/airlock,
/turf/open/floor/plasteel/grimy,
/area/ruin/unpowered)
"bs" = (
/obj/structure/barricade/sandbags,
/turf/template_noop,
/area/ruin/outdoors)
"bB" = (
/obj/structure/sign/poster/contraband/steppyflag,
/turf/closed/wall/r_wall/rust,
/area/ruin/unpowered)
"dw" = (
/obj/structure/ore_box,
/turf/template_noop,
/area/ruin/outdoors)
"dz" = (
/obj/structure/chair/plastic{
	dir = 4
	},
/obj/effect/decal/cleanable/blood,
/turf/template_noop,
/area/ruin/outdoors)
"dZ" = (
/turf/closed/wall/rust,
/area/ruin/outdoors)
"fL" = (
/obj/item/kinetic_crusher,
/obj/effect/decal/cleanable/blood,
/obj/effect/gibspawner/human,
/obj/item/clothing/suit/space/hardsuit/mining,
/turf/template_noop,
/area/ruin/outdoors)
"gN" = (
/obj/structure/sign/poster/contraband/tools,
/turf/closed/wall/r_wall/rust,
/area/ruin/unpowered)
"ih" = (
/turf/closed/wall,
/area/ruin/outdoors)
"lg" = (
/obj/structure/table,
/obj/machinery/microwave,
/turf/open/floor/plasteel/grimy,
/area/ruin/unpowered)
"ll" = (
/turf/open/floor/plating/rust,
/area/ruin/outdoors)
"mf" = (
/obj/structure/bed,
/obj/machinery/light/broken{
	dir = 8
	},
/turf/open/floor/plasteel/grimy,
/area/ruin/unpowered)
"mk" = (
/turf/open/floor/plasteel/grimy,
/area/ruin/unpowered)
"nn" = (
/obj/structure/fans/tiny,
/obj/machinery/door/airlock/mining,
/turf/open/floor/plasteel/mono/dark,
/area/ruin/unpowered)
"oj" = (
/turf/open/floor/plating/wasteland/lit,
/area/ruin/outdoors)
"ov" = (
/obj/structure/sign/warning/gasmask,
/turf/closed/wall/r_wall/rust,
/area/ruin/unpowered)
"pl" = (
/turf/open/floor/plasteel/rockvault,
/area/ruin/unpowered)
"pZ" = (
/obj/structure/barricade/sandbags,
/turf/open/floor/plating/rust,
/area/ruin/outdoors)
"qj" = (
/mob/living/simple_animal/hostile/netherworld/blankbody{
	desc = "What seems to be the remnants of what was once a human.";
	name = "Turned"
	},
/turf/template_noop,
/area/ruin/outdoors)
"ro" = (
/obj/effect/decal/cleanable/oil,
/turf/open/floor/plasteel/mono/dark,
/area/ruin/unpowered)
"rr" = (
/obj/structure/sign/warning/xeno_mining,
/turf/closed/wall/r_wall/rust,
/area/ruin/unpowered)
"rY" = (
/mob/living/simple_animal/hostile/netherworld/blankbody{
	desc = "What seems to be the remnants of what was once a human.";
	name = "Turned"
	},
/turf/open/floor/plasteel/grimy,
/area/ruin/unpowered)
"sj" = (
/obj/machinery/computer/mech_bay_power_console{
	dir = 8
	},
/turf/open/floor/plasteel/rockvault,
/area/ruin/unpowered)
"sJ" = (
/obj/effect/gibspawner/human,
/turf/open/floor/plasteel/grimy,
/area/ruin/unpowered)
"sM" = (
/obj/structure/flora/rock/pile,
/turf/template_noop,
/area/ruin/outdoors)
"sP" = (
/mob/living/simple_animal/hostile/skeleton/plasmaminer,
/turf/template_noop,
/area/ruin/outdoors)
"tN" = (
/turf/template_noop,
/area/ruin/outdoors)
"ub" = (
/obj/machinery/computer{
	dir = 8
	},
/turf/open/floor/plasteel/rockvault,
/area/ruin/unpowered)
"ug" = (
/obj/machinery/suit_storage_unit/mining,
/turf/open/floor/plasteel/mono,
/area/ruin/unpowered)
"uq" = (
/obj/machinery/suit_storage_unit/open,
/turf/open/floor/plasteel/mono,
/area/ruin/unpowered)
"ur" = (
/obj/structure/flora/rock,
/turf/template_noop,
/area/ruin/outdoors)
"vK" = (
/obj/machinery/door/airlock/mining,
/obj/structure/fans/tiny,
/turf/open/floor/plasteel/mono/dark,
/area/ruin/unpowered)
"wY" = (
/obj/structure/table,
/obj/item/stack/sheet/cardboard,
/turf/open/floor/plasteel/grimy,
/area/ruin/unpowered)
"yv" = (
/turf/open/floor/plasteel/mono/dark,
/area/ruin/unpowered)
"yz" = (
/obj/structure/sign/poster/official/no_erp,
/turf/closed/wall/r_wall/rust,
/area/ruin/unpowered)
"yT" = (
/obj/machinery/mineral/ore_redemption,
/turf/open/floor/plasteel/rockvault,
/area/ruin/unpowered)
"yZ" = (
/turf/closed/mineral/random/high_chance/wasteland,
/area/ruin/outdoors)
"BR" = (
/obj/effect/decal/cleanable/oil,
/turf/open/floor/plasteel/rockvault,
/area/ruin/unpowered)
"Ch" = (
/obj/machinery/mineral/equipment_vendor,
/turf/open/floor/plasteel/mono,
/area/ruin/unpowered)
"CL" = (
/obj/structure/sign/poster/random,
/turf/closed/wall/r_wall/rust,
/area/ruin/unpowered)
"CX" = (
/obj/machinery/portable_atmospherics/canister/oxygen,
/obj/machinery/light/broken{
	dir = 4
	},
/turf/open/floor/plasteel/mono,
/area/ruin/unpowered)
"Du" = (
/obj/structure/sign/poster/contraband/space_up,
/turf/closed/wall/r_wall/rust,
/area/ruin/unpowered)
"Fl" = (
/obj/structure/bed,
/obj/effect/gibspawner/human/bodypartless,
/turf/open/floor/plasteel/grimy,
/area/ruin/unpowered)
"Gc" = (
/mob/living/simple_animal/hostile/asteroid/goliath,
/turf/open/floor/plating/rust,
/area/ruin/outdoors)
"Gh" = (
/obj/structure/tank_dispenser/oxygen,
/turf/open/floor/plasteel/mono,
/area/ruin/unpowered)
"HW" = (
/obj/machinery/light/broken{
	dir = 4
	},
/turf/open/floor/plasteel/grimy,
/area/ruin/unpowered)
"Jz" = (
/obj/effect/decal/cleanable/blood,
/mob/living/simple_animal/hostile/netherworld/blankbody{
	desc = "What seems to be the remnants of what was once a human.";
	name = "Turned"
	},
/turf/template_noop,
/area/ruin/outdoors)
"JC" = (
/obj/item/weldingtool,
/obj/effect/decal/cleanable/blood/gibs/up,
/turf/open/floor/plasteel/rockvault,
/area/ruin/unpowered)
"LZ" = (
/obj/effect/decal/cleanable/blood,
/turf/open/floor/plasteel/grimy,
/area/ruin/unpowered)
"Mh" = (
/obj/structure/bed,
/turf/open/floor/plasteel/grimy,
/area/ruin/unpowered)
"NV" = (
/obj/machinery/light/broken,
/obj/effect/decal/cleanable/blood,
/turf/open/floor/plasteel/rockvault,
/area/ruin/unpowered)
"OB" = (
/obj/structure/chair{
	dir = 8
	},
/obj/effect/decal/cleanable/blood,
/turf/open/floor/plasteel/grimy,
/area/ruin/unpowered)
"OQ" = (
/obj/effect/turf_decal/dept/mining,
/turf/open/floor/plasteel/mono/dark,
/area/ruin/unpowered)
"Pk" = (
/obj/item/reagent_containers/food/drinks/beer/light,
/obj/item/cigbutt{
	pixel_x = -10;
	pixel_y = -7
	},
/turf/template_noop,
/area/ruin/outdoors)
"Pn" = (
/obj/item/reagent_containers/food/snacks/donkpocket/warm/berry,
/obj/effect/decal/cleanable/blood/gibs/core,
/obj/effect/decal/cleanable/blood,
/turf/open/floor/plasteel/grimy,
/area/ruin/unpowered)
"Pz" = (
/obj/effect/decal/cleanable/blood,
/turf/open/floor/plasteel/rockvault,
/area/ruin/unpowered)
"PJ" = (
/obj/structure/table/wood,
/obj/item/toy/cards/deck{
	pixel_x = 3;
	pixel_y = 6
	},
/turf/open/floor/plasteel/grimy,
/area/ruin/unpowered)
"PK" = (
/obj/effect/decal/cleanable/blood,
/obj/item/stack/ore/plasma{
	amount = 8
	},
/turf/open/floor/plasteel/rockvault,
/area/ruin/unpowered)
"Qo" = (
/obj/effect/decal/cleanable/blood,
/obj/effect/mob_spawn/human/miner/explorer,
/obj/item/pickaxe,
/turf/template_noop,
/area/ruin/outdoors)
"Qr" = (
/obj/effect/turf_decal/rechargefloor,
/obj/structure/mecha_wreckage/ripley,
/turf/open/floor/plasteel/rockvault,
/area/ruin/unpowered)
"QR" = (
/mob/living/simple_animal/bot/mulebot,
/turf/template_noop,
/area/ruin/outdoors)
"Rk" = (
/obj/effect/decal/cleanable/blood,
/turf/template_noop,
/area/ruin/outdoors)
"SC" = (
/obj/structure/table,
/obj/item/reagent_containers/food/drinks/soda_cans/cola{
	pixel_x = 8;
	pixel_y = 5
	},
/obj/item/toy/figure/miner{
	pixel_x = -5
	},
/obj/machinery/light/broken{
	dir = 4
	},
/turf/open/floor/plasteel/grimy,
/area/ruin/unpowered)
"TI" = (
/obj/item/chair,
/obj/effect/decal/cleanable/blood,
/obj/item/gun/ballistic/automatic/pistol/m1911,
/turf/open/floor/plasteel/grimy,
/area/ruin/unpowered)
"Uu" = (
/obj/machinery/light/broken{
	dir = 1
	},
/obj/effect/decal/cleanable/oil,
/turf/open/floor/plasteel/rockvault,
/area/ruin/unpowered)
"Vw" = (
/turf/closed/wall/r_wall/rust,
/area/ruin/unpowered)
"VL" = (
/obj/machinery/mech_bay_recharge_port{
	dir = 2
	},
/turf/open/floor/plasteel/rockvault,
/area/ruin/unpowered)
"VM" = (
/obj/item/chair{
	dir = 8
	},
/turf/open/floor/plasteel/grimy,
/area/ruin/unpowered)
"Wf" = (
/obj/effect/decal/cleanable/blood,
/obj/item/clothing/glasses/material/mining/gar,
/turf/template_noop,
/area/ruin/outdoors)
"Wz" = (
/obj/item/broken_bottle,
/obj/effect/decal/cleanable/blood/gibs/body,
/turf/open/floor/plasteel/grimy,
/area/ruin/unpowered)
"YN" = (
/obj/effect/decal/cleanable/blood,
/obj/structure/bed,
/turf/open/floor/plasteel/grimy,
/area/ruin/unpowered)
"YS" = (
/obj/machinery/door/airlock/mining,
/turf/open/floor/plasteel/rockvault,
/area/ruin/unpowered)
"YW" = (
/obj/structure/barricade/wooden,
/turf/template_noop,
/area/ruin/outdoors)
"Zp" = (
/obj/structure/marker_beacon,
/turf/template_noop,
/area/ruin/outdoors)

(1,1,1) = {"
ih
ih
dZ
dZ
Vw
Vw
yz
Vw
Vw
Vw
Vw
Vw
yZ
yZ
yZ
yZ
ll
ll
ll
ll
yZ
dZ
"}
(2,1,1) = {"
dZ
ll
yZ
yZ
Vw
mk
Mh
Mh
mf
Mh
Fl
bB
Vw
Vw
Vw
yZ
tN
bs
bs
ll
yZ
dZ
"}
(3,1,1) = {"
dZ
Gc
sM
yZ
Vw
YN
rY
sJ
mk
mk
LZ
Vw
ug
uq
ug
rr
Zp
tN
tN
tN
tN
Zp
"}
(4,1,1) = {"
ih
oj
Rk
yZ
Vw
Mh
mk
mk
mk
mk
mk
vK
yv
ro
OQ
nn
tN
tN
bs
tN
tN
tN
"}
(5,1,1) = {"
dZ
yZ
Qo
yZ
Vw
YN
mk
VM
LZ
mk
mk
Vw
Gh
CX
Ch
ov
tN
tN
pZ
ll
ll
ih
"}
(6,1,1) = {"
dZ
ll
Rk
yZ
Vw
mk
mk
mk
SC
sJ
rY
CL
Vw
Vw
Vw
Pk
dz
tN
tN
ll
yZ
dZ
"}
(7,1,1) = {"
dZ
ll
ai
yZ
Vw
Vw
an
Vw
Du
Vw
Vw
Vw
ll
ll
ll
tN
tN
tN
sM
tN
tN
bs
"}
(8,1,1) = {"
dZ
yZ
tN
yZ
Vw
TI
Wz
Vw
yZ
yZ
yZ
yZ
ll
tN
tN
tN
tN
dw
ll
bs
Zp
tN
"}
(9,1,1) = {"
dZ
yZ
tN
yZ
CL
PJ
mk
Vw
Vw
Vw
yZ
ll
ll
tN
tN
bs
bs
bs
ll
yZ
yZ
dZ
"}
(10,1,1) = {"
ih
yZ
tN
yZ
Vw
OB
Pn
rY
lg
Vw
yZ
ll
tN
tN
tN
tN
Zp
ll
ll
yZ
yZ
ih
"}
(11,1,1) = {"
ih
yZ
tN
ll
Vw
mk
HW
mk
wY
Vw
ll
ll
tN
tN
tN
tN
tN
tN
tN
sM
tN
tN
"}
(12,1,1) = {"
dZ
ll
tN
ur
Vw
Vw
gN
Vw
Vw
Vw
ll
ll
ll
tN
tN
tN
tN
tN
tN
tN
tN
Zp
"}
(13,1,1) = {"
ih
ll
Zp
tN
tN
YW
YW
Zp
sP
tN
tN
ll
tN
tN
ur
tN
tN
ll
ll
yZ
yZ
dZ
"}
(14,1,1) = {"
ih
ll
tN
ll
tN
YW
tN
tN
tN
tN
tN
tN
tN
tN
tN
tN
tN
ll
ll
yZ
yZ
dZ
"}
(15,1,1) = {"
dZ
ll
tN
ll
yZ
yZ
yZ
ll
ll
tN
sM
tN
tN
tN
tN
yZ
yZ
yZ
yZ
yZ
yZ
dZ
"}
(16,1,1) = {"
dZ
yZ
tN
yZ
yZ
yZ
yZ
ll
ll
tN
tN
tN
tN
tN
Zp
Rk
tN
tN
tN
Rk
tN
ih
"}
(17,1,1) = {"
dZ
yZ
tN
yZ
yZ
yZ
yZ
ll
tN
tN
tN
tN
ll
ll
yZ
yZ
yZ
yZ
yZ
tN
Jz
ih
"}
(18,1,1) = {"
dZ
yZ
tN
yZ
yZ
yZ
yZ
ll
tN
QR
tN
ll
ll
ll
ll
yZ
yZ
yZ
yZ
yZ
yZ
dZ
"}
(19,1,1) = {"
ih
yZ
tN
yZ
yZ
yZ
yZ
ll
tN
tN
tN
tN
tN
Zp
tN
tN
tN
tN
tN
tN
Zp
tN
"}
(20,1,1) = {"
dZ
ll
tN
yZ
yZ
yZ
ll
ll
tN
tN
Rk
ll
yZ
yZ
yZ
yZ
yZ
yZ
yZ
yZ
yZ
dZ
"}
(21,1,1) = {"
dZ
tN
tN
yZ
yZ
yZ
ll
ll
tN
tN
tN
tN
ll
yZ
yZ
yZ
yZ
yZ
yZ
yZ
yZ
dZ
"}
(22,1,1) = {"
dZ
tN
yZ
yZ
yZ
yZ
ll
ll
tN
tN
tN
tN
tN
tN
tN
tN
Zp
tN
tN
tN
tN
tN
"}
(23,1,1) = {"
dZ
tN
yZ
yZ
yZ
yZ
ll
ll
tN
sM
tN
qj
tN
tN
ll
yZ
yZ
yZ
sM
ll
tN
ll
"}
(24,1,1) = {"
ih
tN
yZ
yZ
yZ
yZ
ll
Zp
Rk
tN
tN
Rk
tN
yZ
yZ
yZ
yZ
yZ
yZ
yZ
tN
ll
"}
(25,1,1) = {"
ih
tN
tN
yZ
yZ
yZ
tN
tN
tN
tN
tN
tN
tN
yZ
yZ
tN
tN
yZ
yZ
yZ
tN
dZ
"}
(26,1,1) = {"
dZ
yZ
tN
yZ
yZ
ll
tN
Vw
YS
Vw
Vw
Vw
Vw
yZ
tN
sM
Wf
tN
tN
ll
Rk
ih
"}
(27,1,1) = {"
dZ
yZ
Zp
yZ
yZ
ll
tN
Vw
Pz
pl
yT
PK
Vw
ll
ll
tN
tN
tN
tN
Zp
tN
dZ
"}
(28,1,1) = {"
dZ
yZ
tN
yZ
yZ
ll
tN
Vw
Uu
JC
BR
NV
CL
ll
tN
qj
tN
tN
fL
tN
tN
dZ
"}
(29,1,1) = {"
ll
ll
tN
ll
yZ
yZ
tN
Vw
VL
Qr
sj
ub
Vw
ll
tN
tN
Rk
dw
tN
sM
ll
dZ
"}
(30,1,1) = {"
ll
ll
tN
ll
dZ
dZ
Zp
Vw
Vw
Vw
Vw
Vw
Vw
ll
Zp
ll
dZ
dZ
dZ
ih
dZ
dZ
"}
